それ Pronoun それはとってもいい話だ。	that, that one それはとってもいい話はなしだ。 That's a really nice story.  37
一つ Noun それを一つください。	one (thing) それを一ひとつください。 Please give me one of those.  247
一 Noun 一から始めましょう。	one 一いちから始はじめましょう。 Let's start from the beginning.  35
二 Noun その人には二回会った。	two その人ひとには二に回会かい あった。 I met that person twice.  42
二つ Noun ソフトクリームを二つください。	two (things) ソフトクリームを二ふたつください。 Please give me two ice cream cones.  589
三 Noun 彼女は三人の子供の母親だ。	three 彼女かのじょは三さん人にんの子供こどもの母親ははおやだ。 She's the mother of three children.  59
三つ Noun コップを三つ買いました。	three (things) コップを三みっつ買かいました。 I bought three glasses.  1401
四つ Noun 私は腕時計を四つ持っています。	four (things) 私わたしは腕時計うでどけいを四よっつ持もっています。 I have four wristwatches.  3088
四 Noun 四月に大学に入学しました。	four 四し月がつに大学だいがくに入学にゅうがくしました。 I entered my university in April.  122
これ Noun これをください。	this, this one これをください。 I'll have this please.  57
四 Noun ハワイは四回目です。	four ハワイは四よん回目かいめです。 This is my fourth trip to Hawaii.  122
五つ Noun 桃を五つください。	five (things) 桃ももを五いつつください。 I'd like five peaches, please.  4742
五 Noun 五人で旅行に行きました。	five 五ご人にんで旅行りょこうに行いきました。 Five of us went on a trip.  105
六つ Noun 息子は六つになりました。	six (things) 息子むすこは六むっつになりました。 My son turned six.  8020
六 Noun 彼には子供が六人います。	six 彼かれには子供こどもが六ろく人にんいます。 He has six children.  149
七 Noun バナナが七本あります。	seven バナナが七なな本ほんあります。 There are seven bananas.  169
七つ Noun この子は今年七つになります。	seven (things) この子こは今年ことし七ななつになります。 Our kid's turning seven this year.  7460
八 Noun りんごを八個ください。	eight りんごを八はち個こください。 Please give me eight apples.  160
八つ Noun あの家には時計が八つあります。	eight (things) あの家いえには時計とけいが八やっつあります。 There are eight clocks in that house.  10055
なる Verb 彼は医者になりました。	become 彼かれは医者いしゃになりました。 He became a doctor.  19
九 Noun 野球は九人で1チームです。	nine 野球やきゅうは九きゅう人にんで1ひとチームです。 In baseball there are nine people on one team.  184
九つ Noun 娘は明日九つになります。	nine (things) 娘むすめは明日あす九ここのつになります。 My daughter's turning nine tomorrow.  17641
十 Noun その子は指で十数えました。	ten その子こは指ゆびで十じゅう数かぞえました。 The child counted to ten on her fingers.  52
百 Noun 私の祖母は百才です。	hundred 私わたしの祖母そぼは百ひゃく才さいです。 My grandmother is 100 years old.  213
千 Noun 千円貸してください。	thousand 千せん円貸えん かしてください。 Please lend me 1000 yen.  336
万 Noun この靴は1万円です。	ten thousand この靴くつは1いち万まん円えんです。 These shoes are ten thousand yen.  300
円 Noun そこに大きな円を描いて。	circle そこに大おおきな円えんを描かいて。 Draw a big circle there.  503
円 Noun カレーライスは700円です。	yen カレーライスは700ななひゃく円えんです。 The curry and rice is 700 yen.  503
時 Noun 時の経つのは早い。	time 時ときの経たつのは早はやい。 Time passes by quickly.  87
する Verb 友達と一緒に宿題をした。	do, make 友達ともだちと一緒いっしょに宿題しゅくだいをした。 I did my homework with a friend.  10
時々 Adverb 彼は時々遅刻します。	sometimes 彼かれは時々ときどき遅刻ちこくします。 He's sometimes late.  2199
日 Noun 私たちは先月11日に結婚しました。	day 私わたしたちは先月11せんげつ じゅういち日にちに結婚けっこんしました。 We got married last month on the 11th.  94
六日 Noun 六日前に日本に帰ってきました。	six days, 6th of the month 六日むいか前まえに日本にほんに帰かえってきました。 I came back to Japan six days ago.  111256
三日 Noun 手紙が届くのに三日かかりました。	three days, 3rd of the month 手紙てがみが届とどくのに三日みっかかかりました。 It took three days for the letter to arrive.  182214
五日 Noun 五月五日は祝日です	five days, 5th of the month 五月ごがつ五日いつかは祝日しゅくじつです May 5th is a holiday.  149693
八日 Noun 八日からイギリスに行きます。	eight days, 8th of the month 八日ようかからイギリスに行いきます。 I go to England on the eighth.  161821
二十日 Noun 来月の二十日は弟の誕生日です。	20 days, 20th of the month 来月らいげつの二十日はつかは弟おとうとの誕生日たんじょうびです。 The 20th of next month is my little brother's birthday.  32654
二日 Noun 私は二日待った。	two days, 2nd of the month 私わたしは二日ふつか待まった。 I waited two days.  131093
九日 Noun 九日に荷物が届きます。	nine days, 9th of the month 九日ここのかに荷物にもつが届とどきます。 The package will arrive on the ninth. 
ところ Noun 私は友達のところに泊まった。	place 私わたしは友達ともだちのところに泊とまった。 I stayed at my friend's place for the night.  92
一日 Noun 来月の一日は空いていますか。	1st of the month 来月らいげつの一日ついたちは空あいていますか。 Are you free on the 1st of next month?  182214
十日 Noun 十日後に帰ります。	ten days, 10th of the month 十日とおか後ごに帰かえります。 I'll come home in ten days.  79296
七日 Noun 先月の七日に孫が生まれました。	seven days, 7th of the month 先月せんげつの七日なのかに孫まごが生うまれました。 My grandchild was born on the seventh of last month.  161821
四日 Noun 新学期は来月の四日からです。	four days, 4th of the month 新学期しんがっきは来月らいげつの四日よっかからです。 The new school term starts on the fourth of next month. 
月 Noun 今夜は月がとてもきれいです。	moon 今夜こんやは月つきがとてもきれいです。 The moon looks so beautiful tonight.  535
水 Noun 水を一杯ください。	water 水みずを一杯いっぱいください。 Please give me a glass of water.  309
金 Noun これはかなり金がかかった。	money これはかなり金かねがかかった。 This cost quite a bit of money.  269
日曜日 Noun 日曜日は海に行きました。	Sunday 日曜日にちようびは海うみに行いきました。 We went to the seaside on Sunday.  3720
土曜日 Noun 土曜日の夜はクラブに行きます。	Saturday 土曜日どようびの夜よるはクラブに行いきます。 I'm going to a club Saturday night.  5196
やる Verb 一緒に宿題をやろう。	do 一緒いっしょに宿題しゅくだいをやろう。 Let's do our homework together.  78
金曜日 Noun 金曜日の夜は友達と出かけます。	Friday 金曜日きんようびの夜よるは友達ともだちと出でかけます。 I go out with my friends on Friday nights.  7625
月曜日 Noun 月曜日に会いましょう。	Monday 月曜日げつようびに会あいましょう。 Let's meet on Monday.  7822
木曜日 Noun 木曜日は仕事が休みです。	Thursday 木曜日もくようびは仕事しごとが休やすみです。 Thursday is my day off work.  13245
曜日 Noun 曜日を間違えました。	day of the week 曜日ようびを間違まちがえました。 I got the day of the week wrong.  29940
火曜日 Noun 火曜日に会議があります。	Tuesday 火曜日かようびに会議かいぎがあります。 There's a meeting on Tuesday.  12773
水曜日 Noun 水曜日はバイトがあります。	Wednesday 水曜日すいようびはバイトがあります。 I have a part-time job on Wednesdays.  12590
週 Noun その次の週は空いてますか。	week その次つぎの週しゅうは空あいてますか。 Are you free the following week?  4817
年 Noun 新しい年が始まりました。	year, age 新あたらしい年としが始はじまりました。 A new year has started.  99
分かる Verb 質問の意味は分かりましたか。	understand 質問しつもんの意味いみは分わかりましたか。 Did you understand the meaning of the question?  433
そう Adverb 私もそう思います。	in such manner, that way 私わたしもそう思おもいます。 That's what I think too.  30
何 Noun 夕食には何を食べたいですか。	what, which 夕食ゆうしょくには何なにを食たべたいですか。 What would you like for supper?  53
先 Noun お先にどうぞ。	ahead, first お先さきにどうぞ。 Please go ahead.  259
今年 Noun 今年はイタリアに旅行したい。	this year 今年ことしはイタリアに旅行りょこうしたい。 I want to travel to Italy this year.  2139
今 Adverb 彼は今、勉強しています。	now 彼かれは今いま、勉強べんきょうしています。 He's studying now.  147
今日 Noun 今日は仕事がありません。	today 今日きょうは仕事しごとがありません。 I have no work today.  278
今月 Noun 今月はとても忙しい。	this month 今月こんげつはとても忙いそがしい。 I'm very busy this month.  12272
今週 Noun 今週は日本語のテストがあります。	this week 今週こんしゅうは日本語にほんごのテストがあります。 There's a Japanese test this week.  16739
来る Verb 彼は昼過ぎに来ます。	come 彼かれは昼過ひるすぎに来きます。 He'll come after lunch.  63
来年 Noun 来年一緒に旅行しましょう。	next year 来年らいねん一緒いっしょに旅行りょこうしましょう。 Let's travel together next year.  6153
もう Adverb 彼はもう帰りました。	already, yet 彼かれはもう帰かえりました。 He's already gone home.  103
行く Verb 日曜日は図書館に行きます。	go 日曜日にちようびは図書館としょかんに行いきます。 I go to the library on Sundays.  67
帰る Verb 家に帰ろう。	return, go back 家うちに帰かえろう。 Let's go home.  175
大きい Adjective あの大きい建物は何ですか。	big あの大おおきい建物たてものは何なんですか。 What's that big building?  905
小さい Adjective 小さい花が咲いています。	small 小ちいさい花はなが咲さいています。 Small flowers are blooming.  550
少ない Adjective 今年は雨が少ないです。	few, little 今年ことしは雨あめが少すくないです。 There's not much rain this year.  1081
少し Adverb 少し疲れました。	a little, a little while (polite) 少すこし疲つかれました。 I'm a little tired.  204
多い Adjective 京都にはお寺が多い。	lots of 京都きょうとにはお寺てらが多おおい。 There are a lot of temples in Kyoto.  334
多分 Adverb 彼女は多分家で寝ています。	probably, perhaps 彼女かのじょは多分たぶん家いえで寝ねています。 She's probably sleeping at home.  1977
上げる Verb 彼は荷物をあみだなに上げた。	raise, improve 彼かれは荷物にもつをあみだなに上あげた。 He put the luggage on the luggage rack.  358
よく Adverb 彼女はよく旅行に行きます。	often 彼女かのじょはよく旅行りょこうに行いきます。 She often goes on holiday.  154
上る Verb 猫が屋根に上っている。	go up, climb up 猫ねこが屋根やねに上のぼっている。 The cat's up on the roof.  856
上 Noun 上を向いて。	up, above 上うえを向むいて。 Look up.  120
下 Noun 財布は机の下にあった。	under, below 財布さいふは机つくえの下したにあった。 My purse was under the desk.  219
右 Noun 右のポケットにハンカチが入っています。	right 右みぎのポケットにハンカチが入はいっています。 There's a handkerchief in my right pocket.  564
左 Noun そこを左に曲がってください。	left そこを左ひだりに曲まがってください。 Please turn left there.  715
方 Noun 彼は私の方を見ました。	direction, side 彼かれは私わたしの方ほうを見みました。 He looked at me.  121
大人 Noun お酒は大人になってから。	adult お酒さけは大人おとなになってから。 You can drink alcohol when you're an adult.  1516
人 Noun 彼は優しい人です。	person 彼かれは優やさしい人ひとです。 He's a nice guy.  31
一人 Noun そこには私一人しかいなかった。	one, one person そこには私わたし一人ひとりしかいなかった。 I was the only one there.  97423
どう Adverb あなたはどう思いますか。	how, what あなたはどう思おもいますか。 What do you think?  112
入れる Verb 彼はかばんに手帳を入れた。	put in 彼かれはかばんに手帳てちょうを入いれた。 He put the appointment book in his bag.  234
入る Verb 寒いので中に入ってください。	enter 寒さむいので中なかに入はいってください。 It's cold so please come inside.  126
出る Verb 今朝は早く家を出ました。	go out, leave 今朝けさは早はやく家いえを出でました。 I left the house early this morning.  76
できる Verb 彼女はイタリア語が出来ます。	can do, be good at 彼女かのじょはイタリア語ごが できます。 She knows Italian.  72
出す Verb 彼はかばんから教科書を出した。	take out, turn in 彼かれはかばんから教科書きょうかしょを出だした。 He took the textbook out of his bag.  130
本 Noun 本を１冊買いました。	book, volume 本ほんを１冊買いっさつ かいました。 I bought one book.  208
休む Verb 明日、会社を休みます。	take a day off, take a break 明日あした、会社かいしゃを休やすみます。 I'm off work tomorrow.  1706
体 Noun 私は体が丈夫だ。	body, health 私わたしは体からだが丈夫じょうぶだ。 I'm physically strong.  242
目 Noun 彼女は青い目をしています。	eye 彼女かのじょは青あおい目めをしています。 She has blue eyes.  84
どこ Noun あの本をどこに置きましたか。	where あの本ほんをどこに置おきましたか。 Where did you put that book?  133
口 Noun 口を大きく開けてください。	mouth 口くちを大おおきく開あけてください。 Open wide, please.  145
耳 Noun 彼女は耳がよく聞こえません。	ear, hearing 彼女かのじょは耳みみがよく聞きこえません。 Her hearing isn't very good.  328
上手 Adjectival Noun 妹は歌が上手です。	skilled, good 妹いもうとは歌うたが上手じょうずです。 My little sister can sing.  3003
手 Noun 分かった人は手を上げてください。	hand 分わかった人ひとは手てを上あげてください。 Please raise your hand if you understand.  81
足 Noun 彼は足が長い。	leg, foot 彼かれは足あしが長ながい。 He has long legs.  261
空く Verb レストランは空いていました。	become empty, become less crowded レストランは空すいていました。 The restaurant was empty.  3139
男 Noun 男の人が私たちに話しかけた。	man, male 男おとこの人ひとが私わたしたちに話はなしかけた。 This guy began talking to us.  68
女 Noun 店員は若い女の人でした。	woman, girl 店員てんいんは若わかい女おんなの人ひとでした。 The salesclerk was a young woman.  97
子供 Noun 電車で子供が騒いでいた。	child, kid 電車でんしゃで子供こどもが騒さわいでいた。 Kids were making a racket in the train.  268
あげる Verb この本、あなたにあげます。	give この本ほん、あなたにあげます。 I'll give you this book.  181
好き Adjectival Noun 私はワインが好きです。	favorite, liked 私わたしはワインが好すきです。 I like wine.  368
大好き Adjective 私は犬が大好きだ。	love 私わたしは犬いぬが大好だいすきだ。 I love dogs.  3717
私 Noun 私が行きましょう。	I 私わたしが行いきましょう。 Why don't I go.  41
友達 Noun 私には友達がたくさんいます。	friend, companion 私わたしには友達ともだちがたくさんいます。 I have a lot of friends.  1384
家 Noun 家に遊びに来てください。	house, home, my family 家うちに遊あそびに来きてください。 Please come over to my house.  114
気 Noun 彼は意外に気が小さい。	spirit, temperament 彼かれは意外いがいに気きが小ちいさい。 He's unexpectedly timid.  106
元気 Adjective おかげさまで元気です。	healthy, energetic おかげさまで元気げんきです。 I'm fine, thank you.  1055
天気 Noun 今日はいい天気ですね。	weather 今日きょうはいい天気てんきですね。 It's nice out today.  5509
晴れる Verb 明日は晴れるといいですね。	be sunny, clear up 明日あしたは晴はれるといいですね。 I hope it'll be sunny tomorrow.  3331
こう Adverb こう小さい字は読めない。	like this, this kind of こう小ちいさい字じは読よめない。 I can't read such small letters.  253
昨日 Noun 昨日、友達に会った。	yesterday 昨日きのう、友達ともだちに会あった。 I met a friend yesterday.  878
開ける Verb 窓を開けてください。	open, unlock 窓まどを開あけてください。 Please open the window.  478
開く Verb 32ページを開いてください。	open を/が 32さんじゅうにページを開ひらいてください。 Please open to page 32.  280
閉じる Verb 教科書を閉じてください。	close (book, eyes, etc.) 教科書きょうかしょを閉とじてください。 Please close your textbooks.  1059
閉める Verb ちゃんとドアを閉めてよ。	shut, close ちゃんとドアを閉しめてよ。 Close the door properly.  2053
閉まる Verb お店はもう閉まっていました。	be shut, be closed お店みせはもう閉しまっていました。 The shop had already closed.  5612
聞く Verb 彼女はラジオを聞いています。	hear, ask 彼女かのじょはラジオを聞きいています。 She's listening to the radio.  117
時間 Noun 今は時間がありません。	time, hour 今いまは時間じかんがありません。 I don't have time now.  188
高い Adjective これがこの町で一番高いビルです。	high, tall これがこの町まちで一番いちばん高たかいビルです。 This is the tallest building in town.  294
くれる Verb 友達が誕生日プレゼントをくれた。	give (to me) 友達ともだちが誕生日たんじょうびプレゼントをくれた。 My friend gave me a birthday present.  80
安い Adjective この服はとても安かった。	inexpensive, cheap この服ふくはとても安やすかった。 These clothes were very cheap.  2485
低い Adjective 彼は背が低い。	low, short 彼かれは背せが低ひくい。 He's short.  675
前 Noun その店の前で会いましょう。	front, before その店みせの前まえで会あいましょう。 Let's meet in front of the shop.  88
後 Adverb 仕事の後、映画を見た。	after 仕事しごとの後あと、映画えいがを見みた。 I saw a movie after work.  194
後ろ Noun 後ろを向いて。	back, behind 後うしろを向むいて。 Turn around.  826
午後 Noun 明日の午後、お客様が来る。	afternoon, p.m. 明日あすの午後ごご、お客様きゃくさまが来くる。 A guest is coming to visit tomorrow afternoon.  792
午前 Noun 午前9時のニュースです。	morning, a.m. 午前ごぜん9時くじのニュースです。 And now for the 9.00 a.m. news.  1918
朝 Noun 気持ちのいい朝です。	morning 気持きもちのいい朝あさです。 It's a pleasant morning.  431
昼 Noun 私は昼のドラマを毎日見ます。	daytime, midday, lunch 私わたしは昼ひるのドラマを毎日見まいにち みます。 I watch daytime dramas every day.  2069
かなり Adverb 彼はかなり英語が上手です。	fairly, rather 彼かれはかなり英語えいごが上手じょうずです。 He's pretty good at English.  516
晩 Noun 晩ご飯は食べましたか。	evening (usually from sunset to bedtime) 晩ばんご飯はんは食たべましたか。 Have you had dinner?  901
今晩 Noun 今晩のパーティーは何時からですか。	this evening, tonight 今晩こんばんのパーティーは何時なんじからですか。 From what time is the party tonight?  4532
夜 Noun きのうの夜は家にいました。	night (from sunset to sunrise) きのうの夜よるは家いえにいました。 I was at home last night.  211
食べる Verb 昨日タイカレーを食べました。	eat 昨日きのうタイカレーを食たべました。 I had Thai curry yesterday.  393
飲む Verb 友達とお酒を飲んでいます。	drink 友達ともだちとお酒さけを飲のんでいます。 I'm drinking sake with a friend.  335
ご飯 Noun 私はパンよりご飯が好きだ。	cooked rice, meal 私わたしはパンよりご飯はんが好すきだ。 I prefer rice to bread.  6578
買う Verb 郵便局で切手を買いました。	buy 郵便局ゆうびんきょくで切手きってを買かいました。 I bought a stamp at the post office.  437
見る Verb 私は絵を見るのが好きです。	see, look at 私わたしは絵えを見みるのが好すきです。 I like looking at pictures.  45
見せる Verb その写真を見せてください。	show その写真しゃしんを見みせてください。 Please show me those pictures.  288
もっと Adverb もっと近くに来てください。	more もっと近ちかくに来きてください。 Please come closer.  367
見つける Verb 新しい仕事を見つけました。	find (something) 新あたらしい仕事しごとを見みつけました。 I found a new job.  728
見える Verb ここから富士山がよく見えます。	be visible ここから富士山ふじさんがよく見みえます。 You can see Mount Fuji well from here.  132
見つかる Verb メガネが見つかりません。	be found, be caught メガネが見みつかりません。 I can't find my glasses.  1183
言う Verb 上司が「一杯、飲もう。」と言った。	say, tell 上司じょうしが「一杯いっぱい、飲のもう。」と言いった。 My boss said: Let's have a drink.  32
話す Verb 母と電話で話しました。	speak, tell 母ははと電話でんわで話はなしました。 I spoke to my mother on the phone.  240
読む Verb 彼女は雑誌を読んでいます。	read 彼女かのじょは雑誌ざっしを読よんでいます。 She's reading the magazine.  344
漢字 Noun 漢字は中国から来ました。	Chinese character 漢字かんじは中国ちゅうごくから来きました。 Kanji came from China.  7172
書く Verb 彼に手紙を書きました。	write 彼かれに手紙てがみを書かきました。 I wrote him a letter.  193
覚える Verb 妹は平仮名を全部覚えました。	memorize, learn 妹いもうとは平仮名ひらがなを全部ぜんぶ覚おぼえました。 My little sister learned all the hiragana.  555
そこ Pronoun そこに座ってください。	there そこに座すわってください。 Please sit there.  135
会う Verb また会いましょう。	meet また会あいましょう。 Let's meet again.  264
仕事 Noun 3月は仕事が忙しい。	work, job 3月さんがつは仕事しごとが忙いそがしい。 I have a lot of work in March.  236
場合 Noun 分からない場合は私に聞いてください。	situation, case 分わからない場合ばあいは私わたしに聞きいてください。 Please ask me if you don't understand.  375
車 Noun 弟が車を買った。	car, automobile 弟おとうとが車くるまを買かった。 My younger brother bought a car.  305
電車 Noun 私は電車で通学しています。	train 私わたしは電車でんしゃで通学つうがくしています。 I go to school by train.  1809
駅 Noun 駅はどこですか。	railway station 駅えきはどこですか。 Where's the station?  817
道 Noun この道を真っ直ぐ行くと駅です。	way, road, street この道みちを真まっ直すぐ行いくと駅えきです。 Go straight along this road to get to the station.  277
他 Noun 他に方法がありません。	other 他ほかに方法ほうほうがありません。 There's no other way.  274
止める Verb 話すのを止めてください。	stop, give up, abolish 話はなすのを止やめてください。 Stop talking, please.  652
ここ Pronoun ここに本があります。	here ここに本ほんがあります。 There's a book here.  116
歩く Verb 駅まで歩きましょう。	walk, go on foot 駅えきまで歩あるきましょう。 Let's walk to the station.  198
走る Verb 彼は毎晩3キロ走っています。	run 彼かれは毎晩3まいばん さんキロ走はしっています。 Every night he runs three kilometers.  320
近く Adverb 駅の近くで食事をした。	near, close to 駅えきの近ちかくで食事しょくじをした。 I ate near the station.  453
近い Adjective 駅はここから近いです。	near, close 駅えきはここから近ちかいです。 The station is near here.  645
近く Noun 私の家は駅の近くです。	vicinity, nearby 私わたしの家いえは駅えきの近ちかくです。 My house is near the station.  453
遠い Adjective 家から学校までは遠いです。	far, distant 家いえから学校がっこうまでは遠とおいです。 It's a long way from my house to the school.  653
長い Adjective 彼女の髪はとても長い。	long 彼女かのじょの髪かみはとても長ながい。 Her hair is very long.  316
短い Adjective 彼は足が短い。	short, brief 彼かれは足あしが短みじかい。 His legs are short.  1071
広い Adjective 彼の家はとても広い。	wide, big 彼かれの家いえはとても広ひろい。 His house is very big.  830
もらう Verb 彼女からプレゼントをもらいました。	receive 彼女かのじょからプレゼントをもらいました。 I got a present from her.  224
全部 Adverb それ、全部ください。	all, wholly それ、全部ぜんぶください。 I'd like all of those, please.  777
国 Noun 私の国について少しお話しましょう。	country 私わたしの国くにについて少すこしお話はなししましょう。 Let me tell you a bit about my country.  373
白い Adjective 彼は歯が白い。	white, blank (for paper) 彼かれは歯はが白しろい。 His teeth are white.  337
赤い Adjective 赤いバラを買いました。	red 赤あかいバラを買かいました。 I bought a red rose.  586
部屋 Noun 私の部屋は2階にあります。	room 私わたしの部屋へやは2階にかいにあります。 My room is on the second floor.  153
米 Noun 日本人はお米が大好きです。	rice (grain) 日本人にほんじんはお米こめが大好だいすきです。 Japanese people love rice.  1104
まだ Adverb 宿題はまだ終わっていません。	(not) yet, still 宿題しゅくだいはまだ終おわっていません。 I haven't finished my homework yet.  134
ある Verb 私の机の上に書類がたくさんあります。	exist, possess 私わたしの机つくえの上うえに書類しょるいがたくさん あります。 There are a lot of documents on my desk.  15
無い Adjective ここには何も無い。	to not be ここには何なにも無ない。 There's nothing here.  1082
とても Adverb この本はとてもおもしろい。	very この本ほんはとてもおもしろい。 This book is very interesting.  426
作る Verb 今、朝ご飯を作っています。	make, create 今いま、朝あさご飯はんを作つくっています。 I'm making breakfast now.  388
使う Verb このパソコンを使ってください。	use このパソコンを使つかってください。 Please use this computer.  248
消す Verb 昼間は電気を消してください。	erase, turn off 昼間ひるまは電気でんきを消けしてください。 Please turn the lights off during the day.  1001
売る Verb 彼は家を売った。	sell を 彼かれは家いえを売うった。 He sold the house.  973
店 Noun 私はこの店によく来ます。	shop, store 私わたしはこの店みせによく来きます。 I come to this store quite often.  354
春 Noun 今年の春は暖かいね。	spring 今年ことしの春はるは暖あたたかいね。 It's warm this spring, isn't it.  963
夏 Noun 私は夏が大好き。	summer 私わたしは夏なつが大好だいすき。 I just love summer.  794
秋 Noun 彼女は秋に結婚します。	autumn, fall 彼女かのじょは秋あきに結婚けっこんします。 She'll get married this fall.  1260
冬 Noun カナダの冬はとても寒いです。	winter カナダの冬ふゆはとても寒さむいです。 Canada's winters are very cold.  1235
みんな Noun みんなにお菓子をあげましょう。	all, everybody みんなにお菓子かしをあげましょう。 Let's give everyone some sweets.  257
暑い Adjective 今日はとても暑い。	hot (temperature of the air) 今日きょうはとても暑あつい。 It's very hot today.  2161
熱い Adjective このスープはとても熱い。	hot (things, touch) このスープはとても熱あつい。 This soup is very hot.  1315
寒い Adjective この部屋は寒いです。	cold (temperature of the air) この部屋へやは寒さむいです。 It's cold in this room.  1282
暖かい Adjective このコートはとても暖かい。	warm このコートはとても暖あたたかい。 This coat is really warm.  4365
新しい Adjective 彼の車は新しい。	new 彼かれの車くるまは新あたらしい。 His car is new.  591
古い Adjective 私は古い車が好きです。	old 私わたしは古ふるい車くるまが好すきです。 I like old cars.  909
良い Adjective 彼女は良い友達です。	good 彼女かのじょは良いい友達ともだちです。 She's a good friend.  584
悪い Adjective たばこは体に悪い。	bad たばこは体からだに悪わるい。 Cigarettes are bad for your health.  217
思う Verb 私もそう思います。	think 私わたしもそう思おもいます。 I think so too.  43
いつも Adverb 彼女はいつも元気だ。	always 彼女かのじょはいつも元気げんきだ。 She's always full of energy.  241
忘れる Verb 約束を忘れないでください。	forget, leave behind 約束やくそくを忘わすれないでください。 Please don't forget your promise.  349
考える Verb よく考えてください。	think, consider よく考かんがえてください。 Please think carefully.  109
決める Verb 帰国することに決めました。	decide, agree upon 帰国きこくすることに決きめました。 I've decided to go back to my country.  910
決まる Verb 旅行の日程が決まりました。	be decided 旅行りょこうの日程にっていが決きまりました。 I've decided on my travel schedule.  1287
知る Verb 誰もその話を知らない。	(get to) know, realize 誰だれもその話はなしを知しらない。 No one knows that story.  85
一番 Adverb 彼はクラスで一番背が高い。	most 彼かれはクラスで一番いちばん背せが高たかい。 He's the tallest in class.  620
住む Verb 彼は会社の近くに住んでいる。	live, reside 彼かれは会社かいしゃの近ちかくに住すんでいる。 He lives near his office.  597
名前 Noun あなたの名前を教えてください。	name あなたの名前なまえを教おしえてください。 Please tell me your name.  378
食べ物 Noun 日本の食べ物はとても美味しいです。	food 日本にっぽんの食たべ物ものはとても美味おいしいです。 Japanese food is very delicious.  5010
いつ Noun 彼女はいつ来ますか。	when 彼女かのじょはいつ来きますか。 When is she coming?  443
飲み物 Noun 何か飲み物が欲しいな。	beverage, drink 何なにか飲のみ物ものが欲ほしいな。 I could really use something to drink.  8782
重い Adjective このかばんは重いです。	heavy, serious (illness) このかばんは重おもいです。 This bag is heavy.  825
軽い Adjective この靴はとても軽い。	light, light weight この靴くつはとても軽かるい。 These shoes are very light.  643
送る Verb 彼の家に荷物を送りました。	send 彼かれの家いえに荷物にもつを送おくりました。 I sent a package to his house.  562
取る Verb テストでいい点を取った。	take, get テストでいい点てんを取とった。 I got a good grade on the test.  289
待つ Verb あなたが来るのを待っています。	wait, wait for あなたが来くるのを待まっています。 I am waiting for you to come.  203
持つ Verb 私は車を持っています。	have, possess 私わたしは車くるまを持もっています。 I have a car.  127
気持ち Noun 彼の気持ちが分からない。	feeling (about something, emotion) 彼かれの気持きもちが分わからない。 I don't understand his feelings.  571
生きる Verb 皆一生懸命生きている。	live (one's life) 皆一生懸命みんな いっしょうけんめい生いきている。 They're all living their lives the best way that they can.  331
どちら Noun 肉と魚とどちらが好きですか。	which 肉にくと魚さかなとどちらが好すきですか。 Which do you prefer, meat or fish?  1204
先生 Noun 私は日本語の先生になりたいです。	teacher (respectful title) 私わたしは日本語にほんごの先生せんせいになりたいです。 I want to become a Japanese teacher.  205
大学 Noun 大学に行ってもっと勉強したいです。	university, college 大学だいがくに行いってもっと勉強べんきょうしたいです。 I want to go to college and study more.  999
学生 Noun 彼は真面目な学生です。	student 彼かれは真面目まじめな学生がくせいです。 He's a serious student.  1481
大学生 Noun 姉は大学生です。	university student 姉あねは大学生だいがくせいです。 My big sister's a college student.  6609
学校 Noun 学校は8時半に始まります。	school 学校がっこうは8時半はちじはんに始はじまります。 School starts at 8:30.  596
高校生 Noun 私の弟は高校生です。	high school student 私わたしの弟おとうとは高校生こうこうせいです。 My little brother's a high school student.  4215
教える Verb 彼は数学を教えています。	teach, tell 彼かれは数学すうがくを教おしえています。 He teaches mathematics.  470
勉強 Verbal Noun 私は日本語を勉強しています。	study 私わたしは日本語にほんごを勉強べんきょうしています。 I'm studying Japanese.  1605
強い Adjective 今日は風が強い。	strong 今日きょうは風かぜが強つよい。 There's a strong wind today.  304
どれ Noun この中でどれが好きですか。	what, which この中なかでどれが好すきですか。 Which of these do you like?  870
弱い Adjective その子は体が少し弱い。	weak その子こは体からだが少すこし弱よわい。 That child has a somewhat weak constitution.  1561
引く Verb このドアは引いてください。	pull, draw このドアは引ひいてください。 Please pull this door open.  497
質問 Verbal Noun 質問のある方はどうぞ。	question 質問しつもんのある方かたはどうぞ。 Please feel free to ask any questions.  843
難しい Adjective この本は難しいですね。	difficult この本ほんは難むずかしいですね。 This book is difficult.  1764
数 Noun グラスの数が足りません。	(the) number グラスの数かずが足たりません。 There are not enough glasses.  254
勝つ Verb 今日はヤンキースが勝った。	win 今日きょうはヤンキースが勝かった。 The Yankees won today.  1543
負ける Verb 私たちのチームはその試合で負けた。	lose, be defeated 私わたしたちのチームはその試合しあいで負まけた。 Our team lost the game.  1397
本当に Adverb あなたが本当に好きです。	really, truly あなたが本当ほんとうに好すきです。 I really like you.  442
要る Verb 予約は要りません。	need, require 予約よやくは要いりません。 Reservations are not required.  4358
ドア Noun ドアを開けてください。	door ドアを開あけてください。 Please open the door.  341
時計 Noun 時計を見たらちょうど3時だった。	clock, watch 時計とけいを見みたらちょうど3時さんじだった。 I looked at the clock and it was exactly three.  1619
払う Verb 私が払いましょう。	pay 私わたしが払はらいましょう。 Let me pay for that.  1068
切る Verb この紙を半分に切ってください。	cut この紙かみを半分はんぶんに切きってください。 Please cut this paper in half.  428
変える Verb 旅行の日程を変えました。	to change (st) 旅行りょこうの日程にっていを変かえました。 I changed our travel schedule.  718
乗る Verb 駅からはタクシーに乗ってください。	ride, take 駅えきからはタクシーに乗のってください。 Please take a taxi from the station.  397
着る Verb 今日はスーツを着ています。	wear, put on 今日きょうはスーツを着きています。 I'm wearing a suit today.  510
立つ Verb 彼はステージに立った。	stand, rise 彼かれはステージに立たった。 He stood on stage.  166
座る Verb 私は窓側の席に座った。	sit, sit down 私わたしは窓側まどがわの席せきに座すわった。 I sat in a window seat.  853
次 Noun 次はいつ会いましょうか。	next 次つぎはいつ会あいましょうか。 When shall we meet again?  323
喋る Verb 彼女はよく喋るね。	chat, talk 彼女かのじょはよく喋るしゃべるね。 She really likes to chat, doesn't she?  1299
動く Verb 動かないで。	move (が) 動うごかないで 。 Freeze!  391
働く Verb 姉は銀行で働いています。	to work 姉あねは銀行ぎんこうで働はたらいています。 My big sister works at a bank.  801
早い Adjective まだ学校へ行くには早い時間です。	early まだ学校がっこうへ行いくには早はやい時間じかんです。 It's still too early to go to school.  311
速い Adjective 彼は走るのが速い。	fast 彼かれは走はしるのが速はやい。 He runs fast.  2183
遅い Adjective 前の車はとても遅い。	slow, late 前まえの車くるまはとても遅おそい。 The car in front is very slow.  1252
始める Verb テストを始めてください。	begin, start を テストを始はじめてください。 Please start the test.  400
始まる Verb 新しい仕事が始まりました。	begin が 新あたらしい仕事しごとが始はじまりました。 My new job started.  1066
終わる Verb 会議は4時に終わります。	finish, end 会議かいぎは4時よじに終おわります。 The conference ends at four o'clock.  611
終わり Noun 夏休みももう終わりだ。	end, conclusion 夏休なつやすみももう終おわりだ。 Summer vacation's already over.  2031
テーブル Noun 新しいテーブルを買いました。	table 新あたらしいテーブルを買かいました。 I bought a new table.  656
去年 Noun 私は去年フランスへ行った。	last year 私わたしは去年きょねんフランスへ行いった。 I went to France last year.  2474
紙 Noun 紙と鉛筆はありますか。	paper 紙かみと鉛筆えんぴつはありますか。 Do you have paper and pencil?  1236
楽しむ Verb 今日は一人の時間を楽しみたい。	enjoy 今日きょうは一人ひとりの時間じかんを楽たのしみたい。 Today I would like to enjoy some time to myself.  1799
楽しい Adjective 彼はとても楽しい人です。	fun, enjoyable 彼かれはとても楽たのしい人ひとです。 He's very fun to be with.  926
歌う Verb 私たちは大きな声で歌いました。	sing 私わたしたちは大おおきな声こえで歌うたいました。 We sang loudly.  1695
欲しい Adjective 僕は新しい靴が欲しいです。	want, desire 僕ぼくは新あたらしい靴くつが欲ほしいです。 I want new shoes.  976
色 Noun すてきな色のセーターですね。	color すてきな色いろのセーターですね。 That sweater is a wonderful color.  407
茶色 Noun 彼女は茶色の靴を履いています。	light brown 彼女かのじょは茶色ちゃいろの靴くつを履はいています。 She's wearing brown shoes.  5141
すぐ Adverb すぐ行きます。	at once, soon すぐ行いきます。 I'll go right away.  162
ゲーム Noun 私たちはビデオゲームをした。	game 私わたしたちはビデオゲームをした。 We played a video game.  2307
書き直す Verb この書類を書き直してください。	rewrite この書類しょるいを書かき直なおしてください。 Please rewrite this document.  25047
直る Verb クーラーはまだ直りません。	be repaired, return to normal クーラーはまだ直なおりません。 The air conditioner hasn't been repaired yet.  9929
線 Noun 赤い線を2本引いて下さい。	line, route (trainなど) 赤あかい線せんを2本引に ほん ひいて下ください。 Please draw two red lines.  1289
曲がる Verb そこを左に曲がってください。	turn そこを左ひだりに曲まがってください。 Please turn left there.  3456
同じ Adjectival Noun 彼の日本語のレベルは私と同じ位だ。	same, identical 彼かれの日本語にほんごのレベルは私わたしと同おなじ位くらいだ。 His Japanese level is about the same as mine.  157
違う Verb 答えが違います。	differ, be wrong 答こたえが違ちがいます。 That's the wrong answer.  298
図書館 Noun 図書館で料理の本を借りた。	library 図書館としょかんで料理りょうりの本ほんを借かりた。 I borrowed a cookbook from the library.  5144
泊まる Verb 今日はこのホテルに泊まります。	stay overnight 今日きょうはこのホテルに泊とまります。 I'm staying at this hotel today.  3281
遊ぶ Verb 子供たちが公園で遊んでいる。	have a good time, play 子供こどもたちが公園こうえんで遊あそんでいる。 The children are playing in the park.  1496
どうして Adverb どうして泣いているの。	why どうして泣ないているの。 Why are you crying?  276
服 Noun 昨日、新しい服を買った。	clothes 昨日きのう、新あたらしい服ふくを買かった。 I bought some new clothes yesterday.  871
お父さん Noun お父さんは会社員です。	father お父とうさんは会社員かいしゃいんです。 My father's a company employee.  1267
父 Noun 私は父が大好きです。	(speaker's)father 私わたしは父ちちが大好だいすきです。 I love my father.  296
お母さん Noun お母さんによろしくお伝えください。	mother お母かあさんによろしくお伝つたえください。 Please give my best to your mother.  1238
母 Noun 昨日、母と話をしました。	(speaker's) mother 昨日きのう、母ははと話はなしをしました。 I talked to my mother yesterday.  356
親 Noun 親の愛はありがたい。	parent 親おやの愛あいは ありがたい。 We're grateful for our parents' love.  959
姉 Noun 姉は大学生です。	older sister 姉あねは大学生だいがくせいです。 My big sister's a college student.  1057
お姉さん Noun 昨日、あなたのお姉さんに会ったよ。	older sister 昨日きのう、あなたのお姉ねえさんに会あったよ。 I met your older sister yesterday.  6069
妹 Noun 私の妹は小学生です。	younger sister 私わたしの妹いもうとは小学生しょうがくせいです。 My little sister goes to elementary school.  849
おなか Noun おなかが空きました。	stomach おなかが空すきました。 I'm hungry.  7611
兄 Noun 兄は水泳が得意です。	older brother 兄あには水泳すいえいが得意とくいです。 My big brother is good at swimming.  731
お兄さん Noun あなたのお兄さんは何歳?	older brother あなたのお兄にいさんは何歳?なんさい How old's your big brother?  6697
弟 Noun 弟は野球が好きです。	younger brother 弟おとうとは野球やきゅうが好すきです。 My little brother likes baseball.  998
娘 Noun 私の娘はアメリカにいます。	daughter, girl 私わたしの娘むすめはアメリカにいます。 My daughter is in the United States.  223
息子 Noun うちの息子は大学1年生です。	son うちの息子むすこは大学1年生だいがく いちねんせいです。 My son's a college freshman.  796
若い Adjective 彼はまだ若いです。	young 彼かれはまだ若わかいです。 He's still young.  282
彼女 Pronoun 彼女はOLです。	she, one's girlfriend 彼女かのじょはOLおーえるです。 She's an office worker.  82
彼 Noun 彼は私の上司です。	he, one's boyfriend 彼かれは私わたしの上司じょうしです。 He's my senior.  49
結婚 Verbal Noun 彼女は来月結婚します。	marriage 彼女かのじょは来月らいげつ結婚けっこんします。 She's getting married next month.  521
ミーティング Noun 朝9時からミーティングが始まった。	meeting 朝9時あさ 9 じからミーティングが始はじまった。 The meeting started at 9 a.m.  23773
自転車 Noun 毎日、駅まで自転車で行きます。	bicycle 毎日まいにち、駅えきまで自転車じてんしゃで行いきます。 I go to the station by bike every day.  2691
自分 Noun 宿題は自分でやりなさい。	self, oneself 宿題しゅくだいは自分じぶんでやりなさい。 Do your homework by yourself.  56
ご主人 Noun ご主人はお元気ですか。	(your) husband ご主人しゅじんはお元気げんきですか。 How is your husband?  3584
答える Verb 私の質問に答えてください。	answer, reply 私わたしの質問しつもんに答こたえてください。 Please answer my question.  227
別 Adjectival Noun 別の本も見せてください。	another, different 別べつの本ほんも見みせてください。 Please show me another book.  369
病気 Verbal Noun 祖父が病気になった。	illness 祖父そふが病気びょうきになった。 My grandfather got sick.  1173
死ぬ Verb 犬が病気で死にました。	die 犬いぬが病気びょうきで死しにました。 Our dog got sick and died.  183
痛い Adjective 今日は頭が痛いです。	painful 今日きょうは頭あたまが痛いたいです。 I have a headache today.  1184
酒 Noun 彼女は酒に強い。	alcoholic drink, Japanese rice wine 彼女かのじょは酒さけに強つよい。 She holds her liquor well.  463
つける Verb 電気をつけてください。	switch on 電気でんきをつけてください。 Please turn on the light.  168
一杯 Adverb プールは人で一杯です。	full プールは人ひとで一杯いっぱいです。 The pool is packed.  5902
飛ぶ Verb 鳥が飛んでいます。	fly 鳥とりが飛とんでいます。 A bird is flying.  580
飛行機 Noun 息子は飛行機のおもちゃが好きです。	airplane 息子むすこは飛行機ひこうきのおもちゃが好すきです。 My son likes toy airplanes.  2223
お願い Verbal Noun お願いがあります。	request, wish お願ねがいがあります。 I have a favor to ask.  1014
続く Verb 工事は3月まで続きます。	continue, follow が 工事こうじは3月さんがつまで続つづきます。 Construction will continue until March.  677
日記 Noun 私は毎日、日記を付けています。	diary 私わたしは毎日まいにち、日記にっきを付つけています。 I keep a diary every day.  2992
首 Noun きりんの首は長い。	neck きりんの首くびは長ながい。 Giraffes' necks are long.  237
頭 Noun 今朝から頭が痛い。	head 今朝けさから頭あたまが痛いたい。 I've had a headache since this morning.  146
顔 Noun 彼はタオルで顔を拭きました。	face 彼かれはタオルで顔かおを拭ふきました。 He wiped his face with a towel.  69
あれ Noun あれは何ですか。	that over there あれは何なんですか。 What's that?  255
感じる Verb 膝に痛みを感じます。	feel, sense 膝ひざに痛いたみを感かんじます。 I feel a pain in my knee.  206
探す Verb 彼は郵便局を探していました。	search for, look for 彼かれは郵便局ゆうびんきょくを探さがしていました。 He was looking for the post office.  781
落ちる Verb 猿も木から落ちる。	fall, go down 猿さるも木きから落おちる。 Monkeys also fall from trees.  408
お手洗い Noun お手洗いはどこですか。	bathroom (polite) お手洗てあらいはどこですか。 Where's the bathroom?  37293
冷たい Adjective 冷たい飲み物をください。	cold (things, touch) 冷つめたい飲のみ物ものをください。 Please give me a cold drink.  841
汚い Adjective 彼の部屋はとても汚い。	dirty 彼かれの部屋へやはとても汚きたない。 His room is very dirty.  3759
太い Adjective 彼女は足が太い。	thick, fat 彼女かのじょは足あしが太ふとい。 She has fat legs.  1691
曇る Verb 明日は昼頃から曇るでしょう。	become cloudy 明日あすは昼頃ひるごろから曇くもるでしょう。 It'll probably get cloudy around noon tomorrow.  4850
神 Noun 彼は神を信じている。	god, spirit 彼かれは神かみを信しんじている。 He believes in God.  265
まずい Adjective ここの料理はまずい。	bad-tasting, bad ここの料理りょうりはまずい。 The food here is bad.  2137
建てる Verb 私たちは来年、家を建てます。	build, erect 私わたしたちは来年らいねん、家いえを建たてます。 We're building a house next year.  2445
置く Verb 彼はかばんをいすの上に置きました。	put, leave 彼かれはかばんをいすの上うえに置おきました。 He put the bag on the chair.  348
辺 Noun 彼はこの辺に住んでいます。	vicinity, part 彼かれはこの辺へんに住すんでいます。 He lives around here.  4715
黄色い Adjective 彼女に黄色いバラを買いました。	yellow 彼女かのじょに黄色きいろいバラを買かいました。 I bought her a yellow rose.  3156
一緒に Adverb 一緒に帰りましょう。	together, at the same time 一緒いっしょに帰かえりましょう。 Let's go home together.  1265
緑 Noun この町には緑がたくさんあります。	green, foliage この町まちには緑みどりがたくさんあります。 There's a lot of greenery in this town.  1814
易しい Adjective この問題はかなり易しいです。	easy, simple この問題もんだいはかなり易やさしいです。 This problem is pretty easy.  30266
留学生 Noun 彼は留学生です。	student studying abroad 彼かれは留学生りゅうがくせいです。 He's a foreign student.  18155
戻る Verb 今、会社に戻ります。	return, turn back 今いま、会社かいしゃに戻もどります。 I'm going back to the office now.  249
そば Noun そばにいて下さい。	side, vicinity そばにいて下ください。 Stay with me.  540
起きる Verb 私は毎朝6時に起きます。	get up, get out of bed 私わたしは毎朝6時まいあさ ろくじに起おきます。 I get up at six o'clock every morning.  634
起こる Verb 町で大事件が起こりました。	happen 町まちで大事件だいじけんが起おこりました。 There was a major incident in town.  770
起こす Verb 明日、6時に起こしてください。	wake up (someone) 明日あす、6時ろくじに起おこしてください。 Please wake me up tomorrow at six o'clock.  960
起きる Verb 近所で盗難事件が起きました。	occur 近所きんじょで盗難事件とうなん じけんが起おきました。 Some burglaries occurred in the neighborhood.  634
寝る Verb もう寝よう。	sleep, go to sleep もう寝ねよう。 Let's go to bed.  543
細い Adjective 彼女は指が細いですね。	thin, slender, narrow 彼女かのじょは指ゆびが細ほそいですね。 Her fingers are thin.  1124
載せる Verb 皿にケーキを載せました。	place, put on 皿さらにケーキを載のせました。 I put the cake on the plate.  3547
締める Verb 彼はシートベルトを締めた。	tighten, fasten 彼かれはシートベルトを締しめた。 He fastened his seat belt.  5311
甘い Adjective このイチゴは甘い。	sweet このイチゴは甘あまい。 This strawberry is sweet.  1544
こっち Pronoun こっちに来て下さい。	here こっちに来きて下ください。 Please come here.  506
辛い Adjective 彼は辛いものが好きです。	spicy, salty 彼かれは辛からいものが好すきです。 He likes spicy food.  2085
優しい Adjective 彼はとても優しい人です。	gentle, kind 彼かれはとても優やさしい人ひとです。 He's a very kind person.  1326
夫 Noun 私の夫はサラリーマンです。	husband 私わたしの夫おっとはサラリーマンです。 My husband is a company employee.  487
妻 Noun 今日は妻の誕生日だ。	wife 今日きょうは妻つまの誕生日たんじょうびだ。 It's my wife's birthday today.  420
誰 Noun 誰と会ってみたいですか。	who, whom 誰だれと会あってみたいですか。 Who would you like to meet one day?  174
愛する Verb 私は家族を愛しています。	love, care for 私わたしは家族かぞくを愛あいしています。 I love my family.  2817
笑う Verb 赤ん坊が笑っています。	laugh, smile 赤あかん坊ぼうが笑わらっています。 The baby is laughing.  185
酸っぱい Adjective このぶどうは酸っぱいです。	sour このぶどうは酸すっぱいです。 These grapes are sour.  20802
言葉 Noun この言葉の意味が分かりません。	word, language この言葉ことばの意味いみが分わかりません。 I don't understand the meaning of this word.  143
よう Noun 彼女は眠いようです。	way, like, kind [the state of something] 彼女かのじょは眠ねむいようです。 It looks like she's sleepy.  25
呼ぶ Verb ウェイターを呼びましょう。	call, name ウェイターを呼よびましょう。 Let's call the waiter.  231
胸 Noun 胸に少し痛みがあります。	chest 胸むねに少すこし痛いたみがあります。 I have a slight pain in my chest.  272
腰 Noun 昨日から腰が痛い。	hip, lower back 昨日きのうから腰こしが痛いたい。 I've had a pain in my lower back since yesterday.  395
背 Noun 彼女は背が高い。	height, stature 彼女かのじょは背せが高たかい。 She's tall.  623
片仮名 Noun お名前を片仮名で書いてください。	katakana お名前なまえを片仮名かたかなで書かいてください。 Please write your name in katakana.  34512
平仮名 Noun 私は平仮名を全部読めます。	hiragana 私わたしは平仮名ひらがなを全部読ぜんぶ よめます。 I can read all the hiragana.  41512
悲しい Adjective その映画はとても悲しかった。	sad その映画えいがはとても悲かなしかった。 That movie was very sad.  1677
美しい Adjective この絵は美しいです。	beautiful この絵えは美うつくしいです。 This picture is beautiful.  526
授業 Verbal Noun 今日は日本語の授業があります。	class, lesson 今日きょうは日本語にほんごの授業じゅぎょうがあります。 There's going to be a Japanese class today.  3138
あそこ Pronoun あそこにバス停があります。	over there あそこにバス停ていがあります。 There's a bus stop over there.  1268
手伝う Verb 私が手伝いましょう。	help, assist 私わたしが手伝てつだいましょう。 Can I help you?  2370
狭い Adjective 私の部屋は狭いです。	narrow, restricted 私わたしの部屋へやは狭せまいです。 My room is small.  1475
触る Verb 絵に触らないでください。	touch, feel 絵えに触さわらないでください。 Please don't touch the painting.  3510
嫌い Adjective 私はタバコが嫌いです。	dislike 私わたしはタバコが嫌きらいです。 I hate cigarettes.  2018
浴びる Verb 私は朝、シャワーを浴びます。	take a shower 私わたしは朝あさ、シャワーを浴あびます。 I take a shower in the morning.  2346
渇く Verb のどが渇きました。	become thirsty のどが渇かわきました。 I'm thirsty.  10341
髪の毛 Noun 髪の毛が伸びたね。	hair 髪かみの毛けが伸のびたね。 Your hair's longer, isn't it?  3024
肩 Noun 肩が凝りました。	shoulder 肩かたが凝こりました。 My shoulders are stiff.  346
鼻 Noun 鼻がかゆいです。	nose 鼻はながかゆいです。 My nose itches.  811
おいしい Adjective このケーキはおいしいね。	tasty このケーキはおいしいね。 This cake is yummy.  2716
腕 Noun 彼の腕は太い。	arm 彼かれの腕うでは太ふとい。 He has big arms.  343
掛ける Verb 夫の服をハンガーに掛けた。	hang, put on 夫おっとの服ふくをハンガーに掛かけた。 I put my husband's clothes on a hanger.  1704
僕 Noun 僕は学生です。	I (young male) 僕ぼくは学生がくせいです。 I'm a student.  139
だめ Adjectival Noun 彼はだめな男だ。	no good 彼かれはだめな男おとこだ。 He's a loser.  1021
大丈夫 Adjectival Noun 大丈夫ですか。	alright, okay 大丈夫だいじょうぶですか。 Are you okay?  657
風邪 Noun 私は風邪を引きました。	cold (illness) 私わたしは風邪かぜを引ひきました。 I caught a cold.  3785
きれい Adjectival Noun 彼女はとてもきれいだ。	pretty 彼女かのじょはとてもきれいだ。 She's very beautiful.  1138
嬉しい Adjective 彼に会えて嬉しかった。	happy, glad 彼かれに会あえて嬉うれしかった。 I was glad to meet him.  1298
なる (生る) Verb 柿の木に実がたくさんなっています。	produce fruit, grow (on a tree) 柿かきの木きに実みがたくさんなっています。 A lot of fruit is ripening on the persimmon tree. 
ため Noun これは医者のためのサイトです。	sake, purpose これは医者いしゃのためのサイトです。 This is a site for doctors.  98
より Adverb これから、より一層努力します。	more, further これから、より一層努力いっそう どりょくします。 I'll work that much harder from now.  119
七 Noun そのグループのメンバーは全部で七人だ。	seven そのグループのメンバーは全部ぜんぶで七しち人にんだ。 There are seven members of the group in all.  169
九 Noun 私は九月に行く予定です。	nine 私わたしは九く月がつに行いく予定よていです。 I plan to go in September.  184
億 Noun 世界人口は65億人だ。	hundred million 世界人口せかい じんこうは65ろくじゅうご億おく人にんだ。 The world's population is 6.5 billion people.  2153
寺 Noun あそこに古いお寺があります。	buddhist temple あそこに古ふるいお寺てらがあります。 There's an old temple there.  1261
ドル Noun この服は300ドルしました。	dollar この服ふくは300さんびゃくドルしました。 These clothes cost 300 dollars.  2778
日 Noun 夏は日が長い。	sun, sunlight, day 夏なつは日ひが長ながい。 The days are long in summer.  94
火 Noun 火を消して。	fire 火ひを消けして。 Put the fire out.  461
木 Noun 台風で木が倒れた。	tree, wood 台風たいふうで木きが倒たおれた。 The tree fell because of the typhoon.  605
金 Noun 彼女は金のネックレスをしています。	gold, sum of money, Friday 彼女かのじょは金きんのネックレスをしています。 She's wearing a gold necklace.  269
システム Noun 全てのシステムが停止した。	system 全すべてのシステムが停止ていしした。 All systems have stopped.  3228
十分 Adjectival Noun お金はまだ十分あります。	enough, plenty お金かねはまだ十分じゅうぶんあります。 We still have plenty of money.  1098
分 Noun このケーキはあなたの分です。	amount, part, share このケーキはあなたの分ぶんです。 This is your share of the cake.  273
分ける Verb お菓子をみんなで分けました。	divide into parts, sort, share お菓子かしをみんなで分わけました。 We shared the sweets with everyone.  2489
分かれる Verb グループの中で意見が分かれました。	be divided, disperse, branch off グループの中なかで意見いけんが分わかれました。 Opinion was divided within the group.  6030
コンピュータ Noun 新しいコンピュータを買った。	computer 新あたらしいコンピュータを買かった。 I bought a new computer.  7035
何か Noun 道に何か落ちています。	something, some 道みちに何なにか落おちています。 Something has fallen on the road. 
何 Noun 質問は何ですか。	what, which 質問しつもんは何なんですか。 What's the question?  53
まず Adverb 帰ったらまず手を洗いましょう。	first (of all) 帰かえったらまず手てを洗あらいましょう。 When you get home, wash your hands first.  438
先月 Noun 先月、友達の結婚式があった。	last month 先月せんげつ、友達ともだちの結婚式けっこんしきがあった。 My friend's wedding was held last month.  10311
やる Verb 犬にえさをやった。	give (to animals, plants, etc.) 犬いぬにえさをやった。 I fed the dog.  78
先週 Noun 先週は海に行った。	last week 先週せんしゅうは海うみに行いった。 I went to the beach last week.  9452
今まで Adverb 今までどこにいたのですか。	until now, so far 今いままでどこにいたのですか。 Where were you until now?  919
来月 Noun 来月から大学生になります。	next month 来月らいげつから大学生だいがくせいになります。 I'll be a college student beginning next month.  16035
来週 Noun 続きは来週やりましょう。	next week 続つづきは来週らいしゅうやりましょう。 Let's continue next week.  11305
ロボット Noun 彼はロボットの研究をしています。	robot 彼かれはロボットの研究けんきゅうをしています。 He is doing research on robots.  5782
行う Verb その会社は来月、キャンペーンを行う。	do, carry out その会社かいしゃは来月らいげつ、キャンペーンを行おこなう。 That company is going to run a campaign next month.  523
行き Noun 行きは新幹線で行った。	going 行いきは新幹線しんかんせんで行いった。 I went by bullet train on the way over.  3764
行き Noun 東京行きの列車に乗った。	going 東京とうきょう行ゆきの列車れっしゃに乗のった。 I got on the Tokyo-bound train.  3764
帰り Noun 仕事の帰りにビールを飲んだ。	return trip, going home 仕事しごとの帰かえりにビールを飲のんだ。 I had a beer on the way home from work.  2064
ほとんど Adverb お金がほとんどありません。	almost, hardly お金かねがほとんどありません。 There's hardly any money.  362
大きさ Noun この大きさの封筒が欲しいのですが。	size, dimensions この大おおきさの封筒ふうとうが欲ほしいのですが。 I'd like an envelope of this size.  2304
大分 Adverb 大分ピアノが上手くなりました。	very, greatly 大分だいぶピアノが上手うまくなりました。 You've gotten pretty good at the piano.  4402
中 Noun 財布は引き出しの中にあります。	in, inside, middle 財布さいふは引ひき出だしの中なかにあります。 My purse is in the drawer.  71
少年 Noun 少年たちがサッカーをしている。	boy 少年しょうねんたちがサッカーをしている。 The boys are playing soccer.  500
パソコン Noun 彼はパソコンを2台持っています。	personal computer 彼かれはパソコンを2台持にだい もっています。 He has two personal computers.  6138
少しも Adverb あなたは少しも悪くない。	(not) one bit あなたは少すこしも悪わるくない。 It's not your fault at all.  3081
少々 Adverb 塩を少々入れてください。	a little, a few (formal) 塩しおを少々しょうしょう入いれてください。 Please put in a little salt.  2187
多く Noun 毎年多くの人が海外へ旅行する。	many, much 毎年まいとし多おおくの人ひとが海外かいがいへ旅行りょこうする。 A lot of people travel abroad every year.  840
上がる Verb 私たちは２階に上がった。	go up, rise 私わたしたちは２階にかいに上あがった。 We went up to the second floor.  793
もう Adverb コーヒーをもう一杯ください。	another, again コーヒーをもう一杯いっぱいください。 Please give me another cup of coffee.  103
上がる Verb 彼は人前だと上がってしまう。	get nervous, get stage fright 彼かれは人前ひとまえだと上あがってしまう。 He gets nervous in front of other people.  793
年上 Noun 彼は私より年上です。	older, senior 彼かれは私わたしより年上としうえです。 He's older than me.  4584
上り Noun これは上り電車です。	going up, ascent これは上のぼり電車でんしゃです。 This is the train going downtown.  6274
下げる Verb 少し音量を下げてください。	lower, turn down 少すこし音量おんりょうを下さげてください。 Please turn the volume down a little.  1089
プログラム Noun 受付でプログラムを受け取った。	program 受付うけつけでプログラムを受うけ取とった。 I got my program at the reception.  6594
下がる Verb やっと熱が下がった。	come down, hang (down), fall やっと熱ねつが下さがった。 His fever finally went down.  2842
下りる Verb そこの階段を下りてください。	go down, climb down そこの階段かいだんを下おりてください。 Please go down those stairs.  1798
下ろす Verb 棚からその箱を下ろしてください。	bring down, take down, withdraw (money) 棚たなからその箱はこを下おろしてください。 Please take the box down from the shelf.  1863
下り Noun もうすぐ下りの電車が発車します。	downhill, going down もうすぐ下くだりの電車でんしゃが発車はっしゃします。 The train out of the city leaves soon.  7946
よく Adverb よく答えが分かりましたね。	well よく答こたえが分わかりましたね。 You did well in coming up with the answer.  154
年下 Noun 彼は奥さんより年下です。	junior, younger person 彼かれは奥おくさんより年下とししたです。 He's younger than his wife.  7203
下る Verb 小さな船が川を下っています。	go down, go downward 小ちいさな船ふねが川かわを下くだっています。 A small ship is going down the river.  2145
一方 Noun ここは一方通行です。	one way ここは一方いっぽう通行つうこうです。 This is a one-way street.  763
方 Noun 次の方、どうぞ。	person (polite) 次つぎの方かた、どうぞ。 Next please.  121
まま Noun 電気がついたままですよ。	as is, still (in the current state) 電気でんきがついたままですよ。 The light is still on.  151
二人 Noun 今日は妻と二人で食事をします。	two persons 今日きょうは妻つまと二人ふたりで食事しょくじをします。 Today I'm having dinner with my wife, just the two of us. 
大人しい Adjective 私の彼女はとても大人しいです。	gentle, quiet, subdued 私わたしの彼女かのじょはとても大人おとなしいです。 My girlfriend's very quiet.  22423
人々 Noun あの村の人々はとても親切です。	people (polite) あの村むらの人々ひとびとはとても親切しんせつです。 People in that village are very kind.  492
一人で Adverb 今日は一人で映画を見ます。	by oneself 今日きょうは一人ひとりで映画えいがを見みます。 I will see a movie by myself today. 
テレビ Noun 私はテレビをあまり見ません。	television 私わたしはテレビをあまり見みません。 I don't watch much TV.  1094
外人 Noun この町には外人が少ない。	foreigner, alien (less polite) この町まちには外人がいじんが少すくない。 There are few foreigners in this town.  7325
外 Noun 外は暑いよ。	outside, open air 外そとは暑あついよ。 It's hot outside.  262
休日 Noun 休日は家でよくテレビを見ます。	holiday, day off 休日きゅうじつは家いえでよくテレビを見みます。 I often watch television at home on my days off.  8581
休み Noun 木曜日は仕事が休みです。	rest, holiday, absence 木曜日もくようびは仕事しごとが休やすみです。 Thursday is my day off work.  4526
ソフト Noun このソフトで日本語を勉強することができます。	software, programme このソフトで日本語にほんごを勉強べんきょうすることができます。 You can study Japanese with this software.  11204
力 Noun お相撲さんは、みんな力持ちだ。	strength, power お相撲すもうさんは、みんな力ちから持もちだ。 All sumo wrestlers are strong.  235
協力 Verbal Noun このプロジェクトにはみんなの協力が必要です。	cooperation, collaboration このプロジェクトにはみんなの協力きょうりょくが必要ひつようです。 This project requires everyone's cooperation.  2064
人口 Noun その国の人口はどのくらいですか。	population その国くにの人口じんこうはどのくらいですか。 What's the population of that country?  6109
出口 Noun 出口はあそこです。	exit, exit ramp 出口でぐちはあそこです。 The exit's over there.  3680
ただ Noun この温泉はただです。	free この温泉おんせんはただです。 This hot spring is free.  158
入り口 Noun 入り口は向こうです。	entrance 入いり口ぐちは向むこうです。 The entrance is over there.  3549
右手 Noun 私は右手で字を書きます。	right hand 私わたしは右手みぎてで字じを書かきます。 I write right-handed.  1045
左手 Noun 彼女は左手で字を書く。	left hand 彼女かのじょは左手ひだりてで字じを書かく。 She writes left-handed.  1427
下手 Adjectival Noun 私は歌が下手だ。	not good at 私わたしは歌うたが下手へただ。 I'm a terrible singer.  3085
これら Noun 今日はこれらの問題について話し合います。	these 今日きょうはこれらの問題もんだいについて話はなし合あいます。 We will discuss these issues today.  1380
足りる Verb お金が足りなくて買えなかった。	be enough, be sufficient お金かねが足たりなくて買かえなかった。 I couldn't buy it because I didn't have enough money.  2084
足す Verb 母は味噌汁に水を足した。	add, supplement (the same kind of thing) 母ははは味噌汁みそしるに水みずを足たした。 My mother added water to the miso soup.  6806
山 Noun 山の空気はきれいだ。	mountain 山やまの空気くうきはきれいだ。 The mountain air is clean.  380
川 Noun 小さな川を渡りました。	river, stream 小ちいさな川かわを渡わたりました。 I crossed a stream.  744
いずれ Adverb いずれまたお会いしましょう。	eventually, sometime いずれまたお会あいしましょう。 Let's meet again sometime.  707
空く Verb 後ろの席が空いています。	become available or vacant 後うしろの席せきが空あいています。 The rear seat is empty.  3139
空手 Noun 彼は空手を習っています。	karate, empty hand 彼かれは空手からてを習ならっています。 He's learning karate.  19205
空 Noun 空が真っ青です。	sky, weather 空そらが真まっ青さおです。 The sky is bright blue.  425
海外 Noun 彼は海外での生活が長いです。	overseas, abroad 彼かれは海外かいがいでの生活せいかつが長ながいです。 He's lived abroad for a long time.  5834
あまり Adverb このビールはあまり美味しくありません。	(not) really, (not) very このビールはあまり美味おいしくありません。 This beer isn't very good.  361
海 Noun 海は広くて大きい。	sea, ocean 海うみは広ひろくて大おおきい。 The sea is vast and wide.  493
毎日 Noun 私たちは毎日散歩をします。	every day 私わたしたちは毎日まいにち散歩さんぽをします。 We go for a walk every day.  1034
毎年 Noun 私は毎年、海外旅行に行きます。	every year (less formal) 私わたしは毎年まいとし、海外旅行かいがい りょこうに行いきます。 I travel abroad every year.  4659
毎年 Noun 毎年給料が上がる。	every year (more formal) 毎年まいねん給料きゅうりょうが上あがる。 My salary goes up every year.  4659
なお Adverb なお、雨の場合は中止です。	still, in addition なお、雨あめの場合ばあいは中止ちゅうしです。 Moreover, it will be canceled in the event of rain.  1007
毎週 Noun 私は毎週母に電話をします。	every week 私わたしは毎週まいしゅう母ははに電話でんわをします。 I call my mother every week.  12405
毎月 Noun 私は毎月貯金をしています。	every month 私わたしは毎月まいつき貯金ちょきんをしています。 I save money every month.  9249
石 Noun 私は石につまづいた。	stone, small rock 私わたしは石いしにつまづいた。 I tripped on a stone.  566
田んぼ Noun この辺は田んぼがたくさんあります。	rice field この辺へんは田たんぼがたくさんあります。 There are a lot of rice fields around here.  17942
ほぼ Adverb 仕事がほぼ終わりました。	roughly, nearly 仕事しごとがほぼ終おわりました。 My work is almost finished.  1835
花 Noun きれいな花が咲きました。	flower きれいな花はなが咲さきました。 Beautiful flowers have bloomed.  494
林 Noun 私たちは林の中に入っていった。	woods, grove 私わたしたちは林はやしの中なかに入はいっていった。 We entered the woods.  1498
森 Noun 私は森を歩くのが好きです。	thick woods, forest 私わたしは森もりを歩あるくのが好すきです。 I like to walk in the forest.  667
子 Noun その子は日本語が分からない。	child, kid その子こは日本語にほんごが分わからない。 That kid doesn't understand Japanese.  220
サービス Verbal Noun この店はサービスがいい。	service, on the house この店みせはサービスがいい。 The service in this store is good.  5175
女の子 Noun あの女の子を知っていますか。	girl, baby girl あの女おんなの子こを知しっていますか。 Do you know that girl?  754
男の子 Noun 男の子たちがサッカーをしている。	boy, baby boy 男おとこの子こたちがサッカーをしている。 The boys are playing soccer.  1937
私たち Noun 私たちは来月結婚します。	we 私わたしたちは来月結婚らいげつ けっこんします。 We will get married next month.  537
達する Verb 気温は35度に達した。	attain, reach 気温きおんは35度さんじゅうごどに達たっした。 The temperature reached 35 degrees.  4776
グループ Noun 店に学生のグループが来た。	group 店みせに学生がくせいのグループが来きた。 A group of students came to the shop.  2641
家 Noun ここが私の家です。	house, home ここが私わたしの家いえです。 This is my house.  114
家内 Noun 家内は九州出身です。	my wife 家内かないは九州出身きゅうしゅう しゅっしんです。 My wife is from Kyushu.  5331
客 Noun その店は若い客が多いです。	visitor, customer その店みせは若わかい客きゃくが多おおいです。 That shop has a lot of young customers.  553
空気 Noun ここは空気がきれいです。	air, atmosphere ここは空気くうきがきれいです。 The air here is clean.  891
ホテル Noun 今ホテルに着きました。	hotel 今いまホテルに着つきました。 I arrived at the hotel just now.  693
気に入る Verb 新しい靴がとても気に入りました。	like, be pleased with 新あたらしい靴くつがとても気きに入いりました。 I really like my new shoes.  1852
人気 Noun このバンドはとても人気があるよ。	popularity このバンドはとても人気にんきがあるよ。 That band is very popular.  2264
雨 Noun 雨が降っています。	rain 雨あめが降ふっています。 It's raining.  654
雪 Noun クリスマスに雪が降りました。	snow, snowfall クリスマスに雪ゆきが降ふりました。 It snowed at Christmas.  730
まとめる Verb 彼女は荷物をまとめて出て行った。	gather together, summarize 彼女かのじょは荷物にもつをまとめて出でて行いった。 She packed her luggage and left.  2578
青い Adjective ここの海はとても青い。	blue ここの海うみはとても青あおい。 The sea here is very blue.  1130
青 Noun 私の好きな色は青です。	blue, green, green light 私わたしの好すきな色いろは青あおです。 My favorite color is blue.  1456
晴れ Noun 明日の天気は晴れです。	fine weather, clear sky 明日あすの天気てんきは晴はれです。 Tomorrow's weather will be sunny.  14389
明らか Adjective 明らかに彼が悪い。	clear, obvious 明あきらかに彼かれが悪わるい。 It's clearly his fault.  948
やはり Adverb 彼はやはり遅刻しました。	as expected, also, still 彼かれはやはり遅刻ちこくしました。 He was late, as expected.  410
明るい Adjective 彼女は明るい性格です。	bright, cheerful 彼女かのじょは明あかるい性格せいかくです。 She has a cheerful personality.  938
明日 Noun 明日、会社を休みます。	tomorrow 明日あした、会社かいしゃを休やすみます。 I'm off work tomorrow.  706
暗い Adjective 東の空が暗いです。	dark, dreary, shadowy 東ひがしの空そらが暗くらいです。 The eastern sky is dark.  556
昨年 Noun 昨年は地震が多い年でした。	last year (polite) 昨年さくねんは地震じしんが多おおい年としでした。 Last year there were a lot of earthquakes.  5504
はっきり Adverb 今日は山がはっきり見える。	clearly, distinctly 今日きょうは山やまがはっきり見みえる。 You can see the mountains clearly today.  456
一昨年 Noun 一昨年初めて京都へ旅行しました。	the year before last 一昨年おととし初はじめて京都きょうとへ旅行りょこうしました。 I first traveled to Kyoto the year before last.  13709
一昨日 Noun 一昨日彼から電話がありました。	day before yesterday 一昨日おととい彼かれから電話でんわがありました。 There was a phone call from him the day before yesterday.  6991
東 Noun 東の空が暗いです。	east, eastern 東ひがしの空そらが暗くらいです。 The eastern sky is dark.  696
西 Noun 太陽は西に沈みます。	west, western 太陽たいようは西にしに沈しずみます。 The sun sets in the west.  1330
つまり Adverb つまり、あなたは何も知らないのですね。	in short, basically つまり、あなたは何なにも知しらないのですね。 So, basically, you don't know anything.  342
南 Noun 私の家は町の南にあります。	south 私わたしの家いえは町まちの南みなみにあります。 My house is in the south of the town.  1199
北 Noun ロシアは日本の北にあります。	north ロシアは日本にっぽんの北きたにあります。 Russia is north of Japan.  1155
方向 Noun あの人たちは皆、同じ方向を見ている。	direction, course あの人ひとたちは皆みな、同おなじ方向ほうこうを見みている。 Those people are all looking in the same direction.  1375
向かう Verb 今、会社に向かっています。	face, head toward, confront 今いま、会社かいしゃに向むかっています。 I'm heading for the office right now.  353
ビル Noun 私の会社はあのビルの8階です。	building (ローマ字) 私わたしの会社かいしゃはあのビルの8階はちかいです。 My company's on the eighth floor of that building.  1403
向こう Noun 友達は向こうにいます。	the other side, the other party, opponent 友達ともだちは向むこうにいます。 My friend is over there.  892
向く Verb こっちを向いてください。	turn, face, look こっちを向むいてください。 Please turn this way.  935
開く Verb 電車のドアが開きました。	open が 電車でんしゃのドアが開あきました。 The train door opened.  280
聞こえる Verb 隣の部屋からテレビの音が聞こえる。	be heard, be audible 隣となりの部屋へやからテレビの音おとが聞きこえる。 I can hear the sound of the television from the next room.  418
もちろん Adverb もちろん一緒に行きます。	of course, needless to say もちろん一緒いっしょに行いきます。 Of course I'll go with you.  376
年間 Noun 年間5万人がここを訪れます。	period of one year 年間ねんかん5万人ごまんにんがここを訪おとずれます。 This place gets 50,000 visitors a year.  1621
この間 Noun この間彼女に会った。	the other day, recently この間あいだ彼女かのじょに会あった。 I met her the other day.  3418
間 Noun 雲の間から月が出た。	interval, space between 雲くもの間あいだから月つきが出でた。 The moon came out from between the clouds.  197
人間 Noun 人間の心は複雑です。	human being, people 人間にんげんの心こころは複雑ふくざつです。 Man's mind is complex.  140
かつて Adverb かつて私が学生だった頃のことです。	once, formerly かつて私わたしが学生がくせいだった頃ころのことです。 That was when I was still a student.  980
高さ Noun 富士山の高さは3,776メートルです。	height 富士山ふじさんの高たかさは3,776さんぜんななひゃく-ななじゅうろくメートルです。 The height of Mt. Fuji is 3,776m.  182214
最大 Noun これは世界最大の船です。	biggest, largest これは世界せかい最大さいだいの船ふねです。 This is the world's largest ship.  2294
初めて Adverb 東京に来るのは初めてです。	first, for the first time 東京とうきょうに来くるのは初はじめてです。 It's the first time I've been to Tokyo.  607
最初 Noun 5ページの最初を見てください。	the beginning, first 5ごページの最初さいしょを見みてください。 Please look at the beginning of page 5.  364
スポーツ Noun あなたは何かスポーツをしていますか。	sport あなたは何なにかスポーツをしていますか。 Which sport do you play?  5514
初め Noun 初めは上手くできませんでした。	beginning, start 初はじめは上手うまくできませんでした。 I couldn't do it well at first.  1640
今後 Noun 今後ともよろしくお願いします。	after this, in the future (formal) 今後こんごともよろしくお願ねがいします。 I look forward to working with you in the future.  2683
後[のち] Noun 後[のち]に彼は総理大臣になりました。	after, afterwards (formal) 後のちに彼かれは総理大臣そうり だいじんになりました。 He would later become Prime Minister. 
最後 Noun 今日が夏休み最後の日だ。	last, final 今日きょうが夏休なつやすみ最後さいごの日ひだ。 Today's the last day of summer vacation.  347
なぜ Adverb なぜ来なかったの。	why, for what reason なぜ来こなかったの。 Why didn't you come?  293
明後日 Noun 明後日は休日です。	day after tomorrow 明後日あさっては休日きゅうじつです。 The day after tomorrow's a holiday.  9900
牛 Noun 牛が草を食べています。	cattle, cow 牛うしが草くさを食たべています。 The cow is eating grass.  2134
半分 Noun お菓子を友達に半分あげた。	half お菓子かしを友達ともだちに半分はんぶんあげた。 I gave half the sweets to a friend.  952
半年 Noun 日本に来て半年になります。	half a year 日本にっぽんに来きて半年はんとしになります。 It has been half a year since I came to Japan.  3053
そのまま Adverb そのままお待ちください。	like that, unchanged そのままお待まちください。 Please just wait a bit.  445
半月 Noun 半月前に日本に来ました。	half a month 半月はんつき前まえに日本にほんに来きました。 I came to Japan half a month ago.  7891
半日 Noun 今日は半日だけ仕事だ。	half a day 今日きょうは半日はんにちだけ仕事しごとだ。 I'm working only a half-day today.  8672
毎朝 Noun 私は毎朝ジョギングをします。	every morning 私わたしは毎朝まいあさジョギングをします。 I jog every morning.  6784
今朝 Noun 今朝から頭が痛い。	this morning 今朝けさから頭あたまが痛いたい。 I've had a headache since this morning.  2125
もし Adverb もし雨が降ったら、行きません。	if, in case of もし雨あめが降ふったら、行いきません。 I won't go if it rains.  319
昼休み Noun 昼休みに公園に行った。	noon recess, lunch break 昼休ひるやすみに公園こうえんに行いった。 I went to the park at lunchtime.  7948
昼前 Noun 昼前に会議があった。	in the morning, before noon 昼前ひるまえに会議かいぎがあった。 There was a meeting in the morning.  18725
昼間 Noun 昼間は仕事で忙しいです。	daytime, day 昼間ひるまは仕事しごとで忙いそがしいです。 I'm busy with work in the daytime.  2646
毎晩 Noun 姉は毎晩日記を書いています。	every evening 姉あねは毎晩まいばん日記にっきを書かいています。 My older sister writes in her diary every evening.  5367
つもり Noun 明日からタバコを止めるつもりです。	intention, plan 明日あしたからタバコを止やめるつもりです。 I'll stop smoking as of tomorrow.  297
今夜 Noun 今夜は月がとてもきれいです。	tonight, this evening 今夜こんやは月つきがとてもきれいです。 The moon is very beautiful tonight.  958
昨夜 Noun 昨夜、流れ星を見ました。	last night, last evening 昨夜ゆうべ、流ながれ星ぼしを見みました。 I saw some shooting stars last night.  1349
夜中 Noun 夜中に電話がありました。	midnight, dead of night 夜中よなかに電話でんわがありました。 I got a telephone call in the middle of the night.  3254
夕方 Noun 夕方そちらに着きます。	evening 夕方ゆうがたそちらに着つきます。 I'll arrive there in the evening.  1631
やっと Adverb やっと仕事が終わりました。	at last, finally (exclamation) やっと仕事しごとが終おわりました。 Finally, I finished my work.  822
昼食 Noun 昼食に寿司を食べました。	lunch (formal) 昼食ちゅうしょくに寿司すしを食たべました。 I ate sushi for lunch.  4158
朝食 Noun 朝食に納豆を食べました。	breakfast (formal) 朝食ちょうしょくに納豆なっとうを食たべました。 I ate natto for breakfast.  3306
夕食 Noun 夕食は7時です。	supper (polite) 夕食ゆうしょくは7時しちじです。 Dinner's at seven o'clock.  2261
夕飯 Noun 夕飯は寿司でした。	evening meal, supper (かたい) 夕飯ゆうはんは寿司すしでした。 Dinner was sushi.  8536
ニュース Noun 夜のニュースを見ましたか。	news 夜よるのニュースを見みましたか。 Did you see the evening news?  2862
見方 Noun 彼に対する見方が変わりました。	view, way of looking 彼かれに対たいする見方みかたが変かわりました。 My view of him has changed.  6304
花見 Noun 友達と花見をしました。	cherry blossom viewing 友達ともだちと花見はなみをしました。 I went cherry blossom viewing with a friend.  15129
言い方 Noun そんな言い方をしてはいけません。	way of speaking, expression そんな言いい方かたをしてはいけません。 You mustn't talk like that.  2333
話 Noun あなたの話は面白いね。	talk, story あなたの話はなしは面白おもしろいね。 Your story's interesting.  123
ずっと Adverb 父は休みの日はずっとテレビを見ている。	the whole time, from start to finish 父ちちは休やすみの日ひはずっとテレビを見みている。 My father spends his days off watching television all the time.  404
読み Noun 母に読み書きを習いました。	reading, judgment, foresight 母ははに読よみ書かきを習ならいました。 I learned reading and writing from my mother.  10226
読み方 Noun この漢字の読み方を教えてください。	way to read, reading この漢字かんじの読よみ方かたを教おしえてください。 Please tell me how to read this Chinese character.  23580
語る Verb 今夜は大いに語りましょう。	tell (a story), talk about 今夜こんやは大おおいに語かたりましょう。 Let's talk about everything tonight.  680
言語 Noun 彼はアジアの言語を研究している。	language, speech 彼かれはアジアの言語げんごを研究けんきゅうしている。 He's doing research in Asian languages.  4325
ビデオ Noun 私はその番組をビデオに撮った。	video 私わたしはその番組ばんぐみをビデオに撮とった。 I recorded that program on video.  4413
英語 Noun あなたは英語が話せますか。	English あなたは英語えいごが話はなせますか。 Can you speak English?  2013
文字 Noun 壁に文字が書いてあった。	character, letter 壁かべに文字もじが書かいてあった。 There was some writing on the wall.  1331
ローマ字 Noun ローマ字で名前を書いてください。	Roman alphabet ローマ字じで名前なまえを書かいてください。 Please write your name using Roman letters.  30787
字 Noun もっと大きく字を書いてください。	character, letter, handwriting もっと大おおきく字じを書かいてください。 Please write the letters larger.  1378
マンション Noun 彼はマンションに住んでいます。	(modern) apartment complex 彼かれはマンションに住すんでいます。 He lives in an apartment.  1532
書き方 Noun 彼はその漢字の書き方が分からない。	how to write, way of writing 彼かれはその漢字かんじの書かき方かたが分わからない。 He doesn't know how to write that Chinese character.  18290
覚める Verb 今朝は6時に目が覚めた。	awake, wake up (目が) 今朝けさは6時ろくじに目めが覚さめた。 I woke up at six o'clock this morning.  3805
覚ます Verb 子供が目を覚ました。	awaken, wake up 目を 子供こどもが目めを覚さました。 The child woke up.  3996
大会 Noun 夏には川辺で花火大会があります。	mass meeting, tournament 夏なつには川辺かわべで花火はなび大会たいかいがあります。 There are fireworks by the river in summer.  5158
しばらく Adverb そこでしばらく休んでいます。	a short while, long time, for the time being そこでしばらく休やすんでいます。 He's resting over there for a while.  390
会話 Verbal Noun 親子の会話は大切です。	conversation 親子おやこの会話かいわは大切たいせつです。 Conversation between parents and children is important.  1319
話し合う Verb 私たちはよく話し合いました。	discuss, talk about 私わたしたちはよく話はなし合あいました。 We often talked to each other.  3978
合う Verb この靴は私の足に合っている。	fit この靴くつは私わたしの足あしに合あっている。 These shoes fit me.  601
間に合う Verb 授業に間に合いました。	be in time, serve (my) purpose なくても〜 do without 授業じゅぎょうに間まに合あいました。 I made it in time for class.  3366
ガス Noun 地震でガスが止まった。	gas 地震じしんでガスが止とまった。 The gas got cut off due to the earthquake.  4236
会社 Noun 彼は小さな会社に勤めています。	company, corporation 彼かれは小ちいさな会社かいしゃに勤つとめています。 He's working for a small business firm.  705
社会 Noun これは大きな社会問題になっている。	society これは大おおきな社会しゃかい問題もんだいになっている。 This is a major social issue.  1263
社員 Noun 彼は優秀な社員です。	staff member, employee 彼かれは優秀ゆうしゅうな社員しゃいんです。 He's an excellent employee.  3211
仕方 Noun ファイルのダウンロードの仕方が分かりません。	way, method ファイルのダウンロードの仕方しかたが分わかりません。 I don't know how to download the file.  918
うまい Adjective 彼は野球がうまい。	good at (informal) 彼かれは野球やきゅうがうまい。 He's good at baseball.  508
食事 Verbal Noun 今日は上司と食事をする。	meal, dinner (formal) 今日きょうは上司じょうしと食事しょくじをする。 I'm eating with the boss today.  852
火事 Noun 火事です。119番に電話してください。	fire (emergency) 火事かじです。119番ひゃくじゅうきゅうばんに電話でんわしてください。 There's a fire. Please call 119.  4297
大事 Adjectival Noun お体をお大事に。	important (thing) お体からだをお大事だいじに。 Take care of yourself.  1121
事故 Noun 彼は事故で怪我をしました。	accident, incident 彼かれは事故じこで怪我けがをしました。 He was injured in the accident.  1886
サラリーマン Noun 父はサラリーマンです。	office worker, salaried worker, company employee 父ちちはサラリーマンです。 My father's a company employee.  4468
工事 Verbal Noun 工事の音がうるさい。	construction work 工事こうじの音おとがうるさい。 The construction site is noisy.  4630
工場 Noun 彼は食品工場で働いています。	factory, plant 彼かれは食品しょくひん工場こうじょうで働はたらいています。 He's working at the food factory.  2001
電話 Verbal Noun あとで電話します。	telephone, phone call あとで電話でんわします。 I will call you later.  286
電気 Noun 電気をつけてください。	electricity, electric light 電気でんきをつけてください。 Please turn on the light.  3376
バス Noun バスで行こう。	bus バスで行いこう。 Let's go by bus.  1800
車 Noun この道は車が多い。	car この道みちは車くるまが多おおい。 There are many cars on this road.  305
駅員 Noun 駅員に聞きましょう。	station attendant 駅員えきいんに聞ききましょう。 Let's ask the station employee.  13050
通り Noun この通りはにぎやかですね。	boulevard, street この通とおりはにぎやかですね。 This street is lively, isn't it?  372
通る Verb 毎日、この道を通ります。	pass, take (a road), go through 毎日まいにち、この道みちを通とおります。 I take this road every day.  685
クラス Noun この学校は1クラス30人です。	class (ローマ字) この学校がっこうは1クラス30人にんです。 In this school there are 30 people per class.  1923
通う Verb 私はジムに通っています。	go (a place) often, go to and from 私わたしはジムに通かよっています。 I go to a gym.  1820
交通事故 Noun 彼は交通事故を起こした。	traffic accident 彼かれは交通事故こうつうじこを起おこした。 He caused a traffic accident.  10411
水道 Noun 東京は水道の水が不味い。	tap water, water supply 東京とうきょうは水道すいどうの水みずが不味まずい。 Tap water in Tokyo doesn't taste good.  11452
車道 Noun 車道の工事が始まりました。	road, roadway (for vehicles) 車道しゃどうの工事こうじが始はじまりました。 The construction of the roadway started.  14580
トラック Noun トラックを運転できますか。	truck, lorry トラックを運転うんてんできますか。 Can you drive a truck?  2762
道路 Noun この道路は3年前にできました。	road, street この道路どうろは3年前さんねんまえにできました。 This road was completed three years ago.  1944
土地 Noun ここは父の土地です。	land ここは父ちちの土地とちです。 This is my father's land.  1028
地図 Noun 地図を見て来てください。	map, atlas 地図ちずを見みて来きてください。 Please look at the map to get here.  2539
他 Noun 留学生はアジア人が多く、その他は3割です。	others, other things 留学生りゅうがくせいはアジア人じんが多おおく、その他たは3割さんわりです。 The majority of foreign students are Asian, with 30 percent from other regions.  274
パーティー Verbal Noun 明日、うちでパーティーを開きます。	party 明日あした、うちでパーティーを開ひらきます。 Tomorrow I'm having a party at my house.  6557
止める Verb 車を止めて。	stop (sth), turn off 車くるまを止とめて。 Stop the car.  652
止まる Verb 今朝、事故で電車が止まりました。	come to a stop, cease 今朝けさ、事故じこで電車でんしゃが止とまりました。 The train stopped this morning due to an accident.  1321
止む Verb 雨が止みました。	cease, stop, let up 雨あめが止やみました。 The rain stopped.  5131
歩道 Noun 歩道を歩きましょう。	sidewalk, footpath 歩道ほどうを歩あるきましょう。 Let's walk on the pavement.  5912
うまい Adjective うまい寿司屋を見つけたよ。	delicious, tasty (informal) うまい寿司屋すしやを見みつけたよ。 I found a good sushi shop.  508
渡す Verb 彼に手紙を渡しました。	hand over, carry across 彼かれに手紙てがみを渡わたしました。 I handed him the letter.  921
渡る Verb 私たちは歩いて橋を渡った。	cross, ford, go across 私わたしたちは歩あるいて橋はしを渡わたった。 We walked over the bridge.  1078
年度 Noun 売り上げは年度によって違います。	fiscal year, school year 売うり上あげは年度ねんどによって違ちがいます。 Sales differ by fiscal year.  16954
今度 Noun 今度はどこに行きたいですか。	this time, next time 今度こんどはどこに行いきたいですか。 Where do you want to go this time?  427
ガラス Noun クリスタルガラスの花瓶を買いました。	glass (the material) クリスタルガラスの花瓶かびんを買かいました。 I bought a crystal glass vase.  1591
何度 Noun あの店には何度も行きました。	how many degrees, how many times あの店みせには何度なんども行いきました。 I've been to that shop many times.  161821
最近 Noun それは最近話題の本ですね。	lately, recent それは最近さいきん話題わだいの本ほんですね。 That's the book that people have been talking about lately.  1086
遠く Adverb 遠くに船が見えます。	great distance 遠とおくに船ふねが見みえます。 I can see a ship in the distance.  1295
社長 Noun おばは小さな会社の社長です。	president (of a company) おばは小ちいさな会社かいしゃの社長しゃちょうです。 My aunt is the president of a small firm.  1181
コース Noun 私は日本語コースを取っています。	course, class, route 私わたしは日本語にほんごコースを取とっています。 I'm taking a Japanese course.  3945
会長 Noun 初めに会長が挨拶した。	chairman, president 初はじめに会長かいちょうが挨拶あいさつした。 First was the chairman's greetings.  2939
長さ Noun このケーブルの長さは1メートルです。	length このケーブルの長ながさは1いちメートルです。 The length of this cable is one meter.  4968
長男 Noun 彼の長男は8才です。	eldest son 彼かれの長男ちょうなんは8才はっさいです。 His oldest son is eight years old.  4137
長女 Noun うちの長女は10歳です。	eldest daughter うちの長女ちょうじょは10歳じゅっさいです。 Our oldest daughter is ten.  9579
アパート Noun 彼はアパートに住んでいます。	apartment, flat 彼かれはアパートに住すんでいます。 He lives in an apartment.  1450
広がる Verb 留学してから私の世界が広がった。	spread out, reach が 留学りゅうがくしてから私わたしの世界せかいが広ひろがった。 My world expanded after studying abroad.  1652
広さ Noun その家の広さはどれぐらいですか。	area, extent その家いえの広ひろさはどれぐらいですか。 How big is that house?  161821
全体 Noun 全体の80パーセントが完成しました。	whole, total 全体ぜんたいの80はちじゅっパーセントが完成かんせいしました。 80 percent of the total was completed.  1372
全く Adverb 私には全く分かりません。	entirely, truly, indeed 私わたしには全まったく分わかりません。 I don't understand at all.  850
レコード Noun ジャズのレコードをかけました。	record ジャズのレコードをかけました。 I put on a jazz record.  5552
安全 Adjectival Noun 安全が第一です。	safety, security 安全あんぜんが第一だいいちです。 Safety comes first.  2059
一部 Noun 計画を一部変更しましょう。	part 計画けいかくを一部いちぶ変更へんこうしましょう。 Let's change part of the plan.  1249
部分 Noun この部分は問題ないです。	part, section この部分ぶぶんは問題もんだいないです。 There's no problem with this part.  851
国内 Noun この携帯電話が使えるのは国内だけです。	domestic, internal この携帯電話けいたい でんわが使つかえるのは国内こくないだけです。 You can only use this mobile phone domestically.  5114
どんどん Adverb ドアをどんどんとたたいた。	knock (sound) ドアをどんどんとたたいた。 I banged on the door.  2119
全国 Noun 次は全国のお天気です。	the whole country 次つぎは全国ぜんこくのお天気てんきです。 And now for the nation's weather.  5049
外国 Noun 母はまだ外国に行ったことがありません。	foreign country 母はははまだ外国がいこくに行いったことがありません。 My mother hasn't been abroad yet.  2610
国会 Noun 国会が再開した。	National Diet, parliament 国会こっかいが再開さいかいした。 The Diet reconvened.  14767
帰国 Verbal Noun 彼は帰国しました。	return to one's country 彼かれは帰国きこくしました。 He returned to his country.  3480
カメラ Noun カメラが壊れた。	camera カメラが壊こわれた。 The camera broke.  2193
外国人 Noun 日本に住む外国人が増えています。	foreigner (polite) 日本にほんに住すむ外国人がいこくじんが増ふえています。 The number of foreigners living in Japan is increasing.  4495
外国語 Noun 外国語を習うのは難しい。	foreign language 外国語がいこくごを習ならうのは難むずかしい。 Learning foreign languages is hard.  17985
世界 Noun 私は世界旅行をしたい。	world 私わたしは世界せかい旅行りょこうをしたい。 I want to travel around the world.  301
白 Noun 白は雪の色です。	white 白しろは雪ゆきの色いろです。 White is the color of snow.  1216
テープ Noun 彼女はその会話をテープに録音した。	tape, cassette 彼女かのじょはその会話かいわをテープに録音ろくおんした。 She recorded the conversation on tape.  4503
黒い Adjective 彼女は黒いドレスを着ています。	black 彼女かのじょは黒くろいドレスを着きています。 She's wearing a black dress.  504
黒 Noun 黒のボールペンはありますか。	black 黒くろのボールペンはありますか。 Do you have a black pen?  1117
赤ちゃん Noun ベッドで赤ちゃんが眠っています。	baby ベッドで赤あかちゃんが眠ねむっています。 The baby's sleeping in the bed.  7148
赤 Noun 信号が赤に変わりました。	red 信号しんごうが赤あかに変かわりました。 The traffic light changed to red.  1154
ビール Noun 夏はビールがとても美味しい。	beer, lager 夏なつはビールがとても美味おいしい。 Beer tastes really good in summer.  1892
銀行 Noun 銀行は3時まで開いています。	bank 銀行ぎんこうは3時さんじまで開あいています。 The bank is open until three o'clock.  1966
銀 Noun 彼は銀メダルを取った。	silver 彼かれは銀ぎんメダルを取とった。 He got the silver medal.  1450
地下鉄 Noun 私は地下鉄で通勤しています。	subway 私わたしは地下鉄ちかてつで通勤つうきんしています。 I commute to work by subway.  7042
牛肉 Noun 夕食に牛肉を買った。	beef 夕食ゆうしょくに牛肉ぎゅうにくを買かった。 I bought beef for dinner.  13401
ページ Noun 32ページを開いてください。	page 32さんじゅうにページを開ひらいてください。 Please open to page 32.  2464
肉 Noun 肉が焼けました。	meat, flesh 肉にくが焼やけました。 The meat is cooked.  1100
魚 Noun 肉と魚とどちらが好きですか。	fish 肉にくと魚さかなとどちらが好すきですか。 Which do you prefer, meat or fish?  1271
分野 Noun 音楽は彼の得意な分野です。	field, sphere 音楽おんがくは彼かれの得意とくいな分野ぶんやです。 Music is his field of specialty.  7291
野菜 Noun 私は毎日たくさん野菜を食べます。	vegetable 私わたしは毎日まいにちたくさん野菜やさいを食たべます。 I eat a lot of vegetables every day.  4812
グラフ Noun 彼は売上をグラフにした。	graph, chart 彼かれは売上うりあげをグラフにした。 He made a chart of the sales figures.  24771
本屋 Noun 駅前に本屋があります。	bookstore, bookseller 駅前えきまえに本屋ほんやがあります。 There's a bookstore in front of the station.  10368
八百屋 Noun 八百屋でみかんを買いました。	vegetable store, greengrocer 八百屋やおやでみかんを買かいました。 I bought a tangerine at the grocery store.  14531
そば屋 Noun 昼はそば屋に行きました。	soba restaurant 昼ひるはそば屋やに行いきました。 I went to a noodle shop for lunch.  26827
たばこ屋 Noun 私はたばこ屋でライターを買った。	cigarette shop, tobacco store 私わたしはたばこ屋やでライターを買かった。 I bought a lighter from the cigarette shop. 
ポスト Noun 手紙をポストに入れました。	mailbox 手紙てがみをポストに入いれました。 I put the letter in the mailbox.  9559
茶 Noun 私たちは毎日お茶を飲みます。	tea (plain form) 私わたしたちは毎日まいにちお茶ちゃを飲のみます。 We drink tea every day.  2244
お茶 Noun お茶を入れましょうか。	tea (polite) お茶ちゃを入いれましょうか。 Shall I make tea?  1663
茶わん Noun 茶わんにご飯をよそいました。	rice bowl, tea cup 茶ちゃわんにご飯はんをよそいました。 I put some rice into the rice bowl.  20997
味 Noun この料理は味が薄い。	taste, flavor この料理りょうりは味あじが薄うすい。 This food is tasteless.  1304
テスト Verbal Noun テストを始めてください。	test テストを始はじめてください。 Please start the test.  4846
未来 Noun 未来は誰にも分からない。	future 未来みらいは誰だれにも分わからない。 Nobody knows the future.  2002
週末 Noun 週末は家でゆっくりします。	weekend 週末しゅうまつは家うちでゆっくりします。 On the weekend I relax at home.  10666
料理 Verbal Noun 母は料理が得意です。	cooking; handling, management 母ははは料理りょうりが得意とくいです。 My mother is good at cooking.  1345
無理 Adjectival Noun 5時までに家に帰るのは無理です。	unreasonable, impossible, forced 5時ごじまでに家いえに帰かえるのは無理むりです。 I can't possibly get home by five o'clock.  699
あちこち Noun 私たちは朝からあちこち散歩しました。	all over, here and there 私わたしたちは朝あさからあちこち散歩さんぽしました。 We strolled about here and there from the morning.  1737
なくす Verb 今日、鍵をなくしました。	lose, get rid of 今日きょう、鍵かぎをなくしました。 I lost my key today.  3659
無くなる Verb もうお金が無くなりました。	disappear, run short, get lost もうお金かねが無なくなりました。 I've run out of money already.  10746
作文 Noun 日本語で作文を書きました。	composition, essay 日本語にほんごで作文さくぶんを書かきました。 I wrote an essay in Japanese.  16994
用いる Verb 彼はその詩を用いて自分の気持ちを伝えた。	use, make use of 彼かれはその詩しを用もちいて自分じぶんの気持きもちを伝つたえた。 He conveyed his feelings through poetry.  2259
ゴルフ Noun 兄はゴルフを始めました。	golf 兄あにはゴルフを始はじめました。 My older brother started playing golf.  6116
用事 Noun 父は用事で出掛けています。	things to do, errand, business 父ちちは用事ようじで出掛でかけています。 My father is out running errands.  3034
交通費 Noun 会社までの交通費は一ヶ月8,000円です。	traveling expense, transportation cost 会社かいしゃまでの交通費こうつうひは一ヶ月8,000円いっかげつ はっせんえんです。 Transportation to the company costs 8,000 yen a month.  42065
消える Verb 突然、電気が消えた。	be extinguished, disappear 突然とつぜん、電気でんきが消きえた。 Suddenly the electricity went out.  435
消しゴム Noun 消しゴムを貸して下さい。	(rubber) eraser 消けしゴムを貸かして下ください。 Please lend me your eraser.  27534
ラジオ Noun 彼女はラジオを聞いています。	radio 彼女かのじょはラジオを聞きいています。 She's listening to the radio.  3858
売れる Verb 今年の夏はクーラーがよく売れた。	be sold, be in demand 今年ことしの夏なつはクーラーがよく売うれた。 Air conditioners sold well this summer.  3773
売り場 Noun くつ売り場はどこですか。	sales floor, department くつ売うり場ばはどこですか。 Where is the shoe department?  16415
店員 Noun あの店員はとても親切です。	clerk, salesperson あの店員てんいんはとても親切しんせつです。 That shop clerk is very kind.  4998
売店 Noun 駅の売店で雑誌を買った。	kiosk, store 駅えきの売店ばいてんで雑誌ざっしを買かった。 I bought a magazine at a shop in the station.  13766
タクシー Noun タクシーを呼んでください。	taxi, cab タクシーを呼よんでください。 Please call a taxi.  1683
商品 Noun この商品はよく売れている。	goods, commodities この商品しょうひんはよく売うれている。 This product is selling well.  4373
作品 Noun この絵はゴッホの作品だ。	work of art, piece この絵えはゴッホの作品さくひんだ。 This painting is one of van Gogh's works.  956
販売 Verbal Noun 前売券は窓口で販売しています。	sale, selling 前売券まえうりけんは窓口まどぐちで販売はんばいしています。 Advance tickets are being sold at the ticket window.  7762
二階 Noun 兄は二階にいます。	second floor, upstairs 兄あには二階にかいにいます。 My elder brother is on the second floor. 
ゆっくり Adverb もっとゆっくり話してください。	slowly もっとゆっくり話はなしてください。 Please speak more slowly.  471
段階 Noun この段階では、決断するのはまだ早い。	stage, step この段階だんかいでは、決断けつだんするのはまだ早はやい。 At this stage, it is still early to decide.  2734
階段 Noun 私たちは駅の階段をかけ上がった。	steps, flight of stairs 私わたしたちは駅えきの階段かいだんをかけ上あがった。 We ran up the station steps.  737
段々 Adverb 段々仕事が楽しくなってきました。	gradually, one after another 段々だんだん仕事しごとが楽たのしくなってきました。 My work has gradually become more enjoyable.  10271
値段 Noun このベルトの値段は2500円でした。	price このベルトの値段ねだんは2500円にせんごひゃくえんでした。 The price of this belt was 2,500 yen.  4154
レストラン Noun レストランでインド料理を食べました。	restaurant レストランでインド料理りょうりを食たべました。 I ate Indian food at the restaurant.  3446
価格 Noun ガソリンの価格がどんどん上がっている。	price, cost (formal) ガソリンの価格かかくがどんどん上あがっている。 The price of gasoline keeps going up fast.  10514
合格 Verbal Noun 娘が入学試験に合格しました。	passing an examination, eligibility 娘むすめが入学試験にゅうがく しけんに合格ごうかくしました。 My daughter passed the university entrance exam.  8469
夏休み Noun 今日が夏休み最後の日だ。	summer vacation 今日きょうが夏休なつやすみ最後さいごの日ひだ。 Today's the last day of summer vacation.  5532
冬休み Noun 冬休みにお祖父ちゃんの家に行きます。	winter vacation 冬休ふゆやすみにお祖父じいちゃんの家うちに行いきます。 I'm going to grandpa's house during winter break.  27247
カード Noun 支払いはカードでお願いします。	card, credit card 支払しはらいはカードでお願ねがいします。 Please pay by card.  2524
四季 Noun 日本には四季がある。	the four seasons 日本にほんには四季しきがある。 We have four seasons in Japan.  9233
暑さ Noun 今年の夏は暑さが厳しい。	heat, summer heat 今年ことしの夏なつは暑あつさが厳きびしい。 The heat this summer is overbearing.  145003
熱 Noun 昨日の夜、熱が出ました。	fever, heat 昨日きのうの夜よる、熱ねつが出でました。 I had a fever last night.  1712
寒さ Noun 今日は厳しい寒さになるでしょう。	coldness, cold 今日きょうは厳きびしい寒さむさになるでしょう。 It will probably be extremely cold today.  85019
アルバイト Verbal Noun 兄はアルバイトをしています。	casual job, student job, part-time job 兄あにはアルバイトをしています。 My big brother works part-time.  5560
暖める Verb 今、車を暖めています。	warm up (something), heat up を 今いま、車くるまを暖あたためています。 I'm warming up the car now.  17301
暖まる Verb まだ部屋が暖まらない。	get warm が まだ部屋へやが暖あたたまらない。 The room hasn't warmed up yet.  26108
温度 Noun 今、部屋の温度は25度だ。	temperature 今いま、部屋へやの温度おんどは25度にじゅうごどだ。 This room's temperature is currently 25 degrees.  7835
気温 Noun 今日の気温は26度です。	atmospheric temperature 今日きょうの気温きおんは26度にじゅうろくどです。 Today's temperature is 26 degrees.  9372
コピー Verbal Noun 会議で書類のコピーを配った。	copy, photocopy 会議かいぎで書類しょるいのコピーを配くばった。 I handed out copies of the document at the meeting.  5757
台 Noun そこにちょうど良い台がある。	stand, platform そこにちょうど良いい台だいがある。 There's a table that's just right.  932
風 Noun 今日は風が強いです。	wind 今日きょうは風かぜが強つよいです。 The wind is strong today.  287
台風 Noun 台風が近づいている。	typhoon 台風たいふうが近ちかづいている。 The typhoon's getting closer.  7948
事情 Noun あなたの事情はよく分かりました。	circumstances, conditions あなたの事情じじょうはよく分わかりました。 I understand your situation well.  1000
ぶつかる Verb 車が電柱にぶつかった。	hit, bump into に 車くるまが電柱でんちゅうにぶつかった。 The car crashed into the telephone pole.  1758
情報 Noun 学生たちはインターネットでいろいろな情報を集めた。	information 学生がくせいたちはインターネットでいろいろな情報じょうほうを集あつめた。 The students gathered all kinds of information on the Internet.  930
報告 Verbal Noun 昨日の会議について報告があります。	report 昨日きのうの会議かいぎについて報告ほうこくがあります。 There's a report about yesterday's conference.  955
新聞 Noun 今日の新聞、どこに置いた?	newspaper 今日きょうの新聞しんぶん、どこに置おいた? Where did you put today's newspaper?  907
新年 Noun 新年明けましておめでとうございます。	New Year 新年しんねん明あけましておめでとうございます。 Happy new year.  14359
フィルム Noun 旅行のためにたくさんフィルムを買った。	film (外来語) 旅行りょこうのためにたくさんフィルムを買かった。 I bought a lot of film for the trip.  6156
良い Adjective 彼は良いところだけを強調した。	good 彼かれは良よいところだけを強調きょうちょうした。 He only emphasized the strong points.  584
中心 Noun ここが建物の中心です。	center, middle, core ここが建物たてものの中心ちゅうしんです。 This is the center of the building.  1386
安心 Verbal Noun それを聞いて安心しました。	peace of mind, relief それを聞きいて安心あんしんしました。 I was relieved to hear that.  1139
思い出す Verb 大切な用事を思い出しました。	recollect, recall 大切たいせつな用事ようじを思おもい出だしました。 I just remembered something important I need to take care of.  483
デパート Noun 私はデパートで靴を買った。	department store, department 私わたしはデパートで靴くつを買かった。 I bought shoes at the department store.  5134
思い出 Noun 旅行で楽しい思い出ができました。	recollections, memory 旅行りょこうで楽たのしい思おもい出でができました。 I made wonderful memories during my trip.  2684
考え Noun それは良い考えです。	thought, view, idea それは良いい考かんがえです。 That's a good idea.  615
解決 Verbal Noun トラブルがやっと解決した。	solution, settlement トラブルがやっと解決かいけつした。 The problem has finally been solved.  2032
知らせる Verb 皆に会議の日にちを知らせた。	let know, inform 皆みんなに会議かいぎの日ひにちを知しらせた。 I informed everyone of the day of the meeting.  1868
ベッド Noun 彼はベッドで寝ています。	bed 彼かれはベッドで寝ねています。 He's sleeping in the bed.  681
能力 Noun 彼は能力のある社員です。	ability, capacity 彼かれは能力のうりょくのある社員しゃいんです。 He's a resourceful employee.  1395
可能 Adjectival Noun 20キロのダイエットは可能だと思いますか。	possible, potential 20にじゅっキロのダイエットは可能かのうだと思おもいますか。 Do you think it's possible to go on a twenty kilogram diet?  1845
可 Noun このアルバイトは「学生可」ですね。	permitted, OK このアルバイトは「学生がくせい可か」ですね。 So, students can apply for this part-time job, right?  3980
郵便 Noun さっき郵便が届きました。	mail さっき郵便ゆうびんが届とどきました。 The mail has just arrived.  14706
コート Noun 寒かったのでコートを着た。	coat, jacket 寒さむかったのでコートを着きた。 I put on a coat because it was cold.  2811
不便 Adjectival Noun 私の家は駅から遠くて不便です。	inconvenient 私わたしの家いえは駅えきから遠とおくて不便ふべんです。 My house is inconveniently located far from the station.  9805
郵便屋さん Noun 郵便屋さんはもう来ましたか。	mailman 郵便屋ゆうびんやさんはもう来きましたか。 Has the postman already come? 
郵便局 Noun 郵便局で切手を買いました。	post office 郵便局ゆうびんきょくで切手きってを買かいました。 I bought a stamp at the post office.  11321
交番 Noun あそこの交番で道を聞きましょう。	police box あそこの交番こうばんで道みちを聞ききましょう。 Let's ask for directions at that police box.  12590
ノート Noun ノートを開いてください。	notebook, laptop ノートを開ひらいてください。 Please open your notebook.  3433
番地 Noun その建物の番地は分かりますか。	house number, address その建物たてものの番地ばんちは分わかりますか。 Do you know the building's plot number?  9352
番号 Noun この番号に電話してください。	number この番号ばんごうに電話でんわしてください。 Please call this number.  3910
場所 Noun 会社の場所を教えてください。	place, space 会社かいしゃの場所ばしょを教おしえてください。 Please tell me where the office is.  325
近所 Noun 近所にカナダ人が住んでいる。	neighborhood 近所きんじょにカナダ人じんが住すんでいる。 A Canadian lives in my neighborhood.  1907
ワイン Noun ワインを少し飲みました。	wine ワインを少すこし飲のみました。 I drank a little wine.  4320
台所 Noun お母さんは台所にいます。	kitchen お母かあさんは台所だいどころにいます。 Mother's in the kitchen.  1748
住所 Noun この住所に行ってください。	address, one's dwelling この住所じゅうしょに行いってください。 Please go to this address.  3291
便所 Noun 便所はそこです。	bathroom, lavatory 便所べんじょはそこです。 The bathroom is there.  6177
有名 Adjectival Noun ボルドーはワインの生産で有名だ。	famous ボルドーはワインの生産せいさんで有名ゆうめいだ。 Bordeau is famous for wine production.  1459
おかしい Adjective 彼の様子がおかしい。	strange, peculiar, suspicious 彼かれの様子ようすがおかしい。 He's acting strange.  772
名字 Noun あなたの名字は何ですか。	surname, family name あなたの名字みょうじは何なんですか。 What's your surname?  20172
氏名 Noun ここに住所と氏名を書いてください。	full name ここに住所じゅうしょと氏名しめいを書かいてください。 Please write your name and address here.  16015
各国 Noun 各国の代表がニューヨークに集まった。	every country 各国かっこくの代表だいひょうがニューヨークに集あつまった。 Each country's representatives assembled in New York.  10697
町 Noun あの町は緑を増やしています。	town, city quarter あの町まちは緑みどりを増ふやしています。 That town is increasing its greenery.  313
トイレ Noun トイレを掃除しましたか。	toilet トイレを掃除そうじしましたか。 Did you clean the toilet?  3005
都市 Noun 東京は日本一大きな都市です。	city, urban community 東京とうきょうは日本一大にほんいち おおきな都市としです。 Tokyo is the largest city in Japan.  1964
都合 Noun 今日は都合が悪くて行けません。	circumstances 今日きょうは都合つごうが悪わるくて行いけません。 I can't go today because it's not convenient for me.  2058
朝ご飯 Noun 七時に朝ご飯を食べました。	breakfast 七時しちじに朝あさご飯はんを食たべました。 I ate breakfast at seven o'clock.  31094
買い物 Verbal Noun 母は買い物に出かけています。	shopping, purchase 母ははは買かい物ものに出でかけています。 My mother's gone shopping.  5846
キャンプ Verbal Noun 友達とキャンプに行った。	camping, camp 友達ともだちとキャンプに行いった。 I went camping with a friend.  7554
荷物 Noun 彼の家に荷物を送りました。	baggage, package 彼かれの家いえに荷物にもつを送おくりました。 I sent a package to his house.  1789
品物 Noun その店は色々な品物を売っている。	article, thing その店みせは色々いろいろな品物しなものを売うっている。 The shop sells a lot of products.  4218
見物 Verbal Noun 皆で東京見物をした。	sightseeing, looking around 皆みんなで東京とうきょう見物けんぶつをした。 We all went sightseeing in Tokyo.  2836
物 Noun 彼女の家には物がたくさんあります。	thing, object 彼女かのじょの家いえには物ものがたくさんあります。 There are a lot of things in her house.  531
プラスチック Noun このカップはプラスチックです。	plastic このカップはプラスチックです。 This cup is plastic.  11058
忘れ物 Noun 学校に忘れ物をしました。	something left behind, lost item 学校がっこうに忘わすれ物ものをしました。 I left something behind at school.  17535
重さ Noun この荷物の重さを計ってください。	weight この荷物にもつの重おもさを計はかってください。 Please weigh this luggage.  182214
配る Verb 会議で書類を配った。	hand out, distribute 会議かいぎで書類しょるいを配くばった。 I handed out the document at the meeting.  4186
配達 Verbal Noun 彼は新聞配達をしている。	delivery 彼かれは新聞しんぶん配達はいたつをしている。 He's delivering newspapers.  11799
カラー Noun カラーコピーは一枚幾らですか。	color, collar カラーコピーは一枚幾いちまい いくらですか。 How much is one color copy?  9098
心配 Verbal Noun 明日のプレゼンテーションが心配だ。	anxiety, worry, assistance 明日あすのプレゼンテーションが心配しんぱいだ。 I'm worried about tomorrow's presentation.  436
見送る Verb 彼が外国に行くのを見送りました。	see (someone) off 彼かれが外国がいこくに行いくのを見送みおくりました。 I saw him off on his trip overseas.  2124
見送り Verbal Noun 駅に友人の見送りに行きました。	seeing someone off 駅えきに友人ゆうじんの見送みおくりに行いきました。 I went to the station to see off a friend.  10109
受ける Verb 彼は就職試験を受けた。	receive, accept 彼かれは就職試験しゅうしょく しけんを受うけた。 He took an exam to apply for a job.  302
ピアノ Noun 昔、ピアノを習っていました。	piano 昔むかし、ピアノを習ならっていました。 I used to learn the piano.  3723
受け取る Verb 彼からメールを受け取りました。	get (st from so), receive take (as in take as an insult) 彼かれからメールを受うけ取とりました。 I got an email from him.  1542
取れる Verb シャツのボタンが取れた。	come off, be removed シャツのボタンが取とれた。 My shirt button came off.  3521
書き取る Verb 話しのポイントを書き取った。	write down, note down 話はなしのポイントを書かき取とった。 I wrote down the main points of what was said.  42439
届く Verb 昨日、父から手紙が届いた。	reach, be delivered 昨日きのう、父ちちから手紙てがみが届とどいた。 I got a letter from my father yesterday.  1294
スキー Noun 冬はよくスキーに行きます。	ski, skiing 冬ふゆはよくスキーに行いきます。 We go skiing a lot in winter.  8224
届ける Verb これを彼に届けてください。	deliver, notify これを彼かれに届とどけてください。 Please send this to him.  3335
持つ Verb この車はよく持っているね。	last long, keep well この車くるまはよく持もっているね。 This car has lasted a long time.  127
金持ち Noun 彼は金持ちです。	wealthy person 彼かれは金持かねもちです。 He's rich.  6266
持って行く Verb 水を持って行きましょう。	take (somewhere) 水みずを持もって行いきましょう。 Let's take some water with us. 
なかなか Adverb 荷物がなかなか届きません。	not easily, not readily, by no means 荷物にもつがなかなか届とどきません。 The parcel still hasn't arrived.  740
持って来る Verb そのいすを持って来てください。	bring (something) そのいすを持もって来きてください。 Please bring that chair. 
打つ Verb 転んでひざを打ちました。	hit, strike 転ころんでひざを打うちました。 I fell down and hit my knee.  552
投げる Verb ボールをこっちに投げてください。	throw, give up ボールをこっちに投なげてください。 Please throw the ball over here.  1175
生まれる Verb 姉夫婦に男の子が生まれました。	be born, come into existence 姉夫婦あね ふうふに男おとこの子こが生うまれました。 My sister and her husband had a baby boy.  727
プール Noun 私は夏休みにプールに行った。	pool 私わたしは夏休なつやすみにプールに行いった。 I went to the pool during summer vacation.  5342
生む Verb うちのネコが子猫を生みました。	give birth うちのネコが子猫こねこを生うみました。 Our cat had kittens.  2660
女性 Noun そのパーティーに女性は何人来ますか。	female, woman (formal) そのパーティーに女性じょせいは何人来なんにん きますか。 How many women are coming to that party?  399
生産 Verbal Noun ボルドーはワインの生産で有名だ。	production ボルドーはワインの生産せいさんで有名ゆうめいだ。 Bordeau is famous for wine production.  5976
お土産 Noun 父はお土産にお菓子を買ってきた。	souvenir 父ちちはお土産みやげにお菓子かしを買かってきた。 My father bought some sweets as a souvenir.  14977
ホーム Noun もうすぐこのホームに電車が来ます。	(train) platform もうすぐこのホームに電車でんしゃが来きます。 The train will arrive on this platform soon.  4075
生活 Verbal Noun 日本での生活は楽しいです。	life, living 日本にほんでの生活せいかつは楽たのしいです。 Life in Japan is fun.  490
生徒 Noun このクラスの生徒は30人です。	pupil, student このクラスの生徒せいとは30人さんじゅうにんです。 There are 30 students in this class.  1247
中学 Noun 息子は中学に通っています。	middle school (abbrev.) 息子むすこは中学ちゅうがくに通かよっています。 My son goes to junior high.  2869
入学 Verbal Noun 妹は九月にアメリカの大学に入学します。	admission to a school, starting school 妹いもうとは九月くがつにアメリカの大学だいがくに入学にゅうがくします。 My little sister's entering college in the United States in September.  6150
エレベーター Noun エレベーターで下に降りましょう。	elevator エレベーターで下したに降おりましょう。 Let's take the elevator down.  2666
中学生 Noun 息子は中学生です。	middle school sudent 息子むすこは中学生ちゅうがくせいです。 My son is a junior high school student.  4906
小学生 Noun うちの息子は来年、小学生になります。	elementary school student うちの息子むすこは来年らいねん、小学生しょうがくせいになります。 Our son will start primary school next year.  4979
見学 Verbal Noun 今日、工場の見学に行きました。	field trip 今日きょう、工場こうじょうの見学けんがくに行いきました。 We went on a field trip to a factory today.  9058
通学 Verbal Noun 毎朝、通学に1時間かかる。	going to school 毎朝まいあさ、通学つうがくに1時間いちじかんかかる。 It takes me an hour to go to school every morning.  17566
メモ Noun メモを取ってください。	memo メモを取とってください。 Please take notes.  3038
高校 Noun 妹は高校に通っています。	high school 妹いもうとは高校こうこうに通かよっています。 My little sister goes to high school.  2023
小学校 Noun 家の近くに小学校があります。	elementary school 家いえの近ちかくに小学校しょうがっこうがあります。 There's an elementary school near my house.  2630
中学校 Noun 息子の中学校は家から5分です。	middle school 息子むすこの中学校ちゅうがっこうは家いえから5分ごふんです。 My son's junior high is five minutes from our house.  8357
校長 Noun あの人は高校の校長だ。	principal あの人ひとは高校こうこうの校長こうちょうだ。 That person is a high school principal.  5552
パン Noun 朝ご飯にはいつもパンを食べる。	bread 朝あさご飯はんにはいつもパンを食たべる。 I always eat bread for breakfast.  2140
休校 Verbal Noun 学校は今週は休校です。	temporary school closure 学校がっこうは今週こんしゅうは休校きゅうこうです。 School is closed this week.  69165
教会 Noun 私たちは教会で結婚式をしました。	church 私わたしたちは教会きょうかいで結婚式けっこんしきをしました。 We had our wedding in a church.  1777
教育 Verbal Noun 彼は海外で教育を受けました。	education 彼かれは海外かいがいで教育きょういくを受うけました。 He received his education abroad.  2316
育てる Verb 彼女は三人の子を育てました。	raise, bring up 彼女かのじょは三人さんにんの子こを育そだてました。 She raised three children.  2615
びっくりする Verb 大きな音にびっくりしました。	be surprised 大おおきな音おとにびっくりしました。 I was startled by a sudden sound. 
育つ Verb 野菜がよく育っている。	grow, be raised 野菜やさいがよく育そだっている。 The vegetables are growing well.  2362
制度 Noun 来年から新しい制度が始まります。	system, organization 来年らいねんから新あたらしい制度せいどが始はじまります。 A new system will start from next year.  4944
強さ Noun 風の強さに驚きました。	strength, power 風かぜの強つよさに驚おどろきました。 I was surprised by the strength of the wind.  137227
取引 Verbal Noun 私たちは中国の会社と取引しています。	transaction, dealings 私わたしたちは中国ちゅうごくの会社かいしゃと取引とりひきしています。 We're dealing with a Chinese company.  6077
ズボン Noun ズボンが汚れた。	trousers, pants ズボンが汚よごれた。 My trousers got dirty.  2842
引き出し Noun 財布は引き出しの中にあります。	drawer, withdrawal 財布さいふは引ひき出だしの中なかにあります。 My purse is in the drawer.  8516
押さえる Verb ドアを押さえてください。	hold down, hold back ドアを押おさえてください。 Please hold the door.  2269
押し入れ Noun 布団を押し入れにしまいました。	closet 布団ふとんを押おし入いれにしまいました。 I put my futon in the closet.  16739
練習 Verbal Noun 娘は今、バイオリンを練習しています。	practice, training 娘むすめは今いま、バイオリンを練習れんしゅうしています。 My daughter is practicing the violin now.  2943
おもちゃ Noun 赤ちゃんが自動車のおもちゃで遊んでいる。	toy, plaything 赤あかちゃんが自動車じどうしゃのおもちゃで遊あそんでいる。 The baby's playing with the toy car.  9827
習う Verb 彼は空手を習っています。	learn, practice 彼かれは空手からてを習ならっています。 He's learning karate.  4760
慣れる Verb 新しい家にはもう慣れましたか。	grow accustomed to 新あたらしい家いえにはもう慣なれましたか。 Have you gotten used to the new house yet?  1694
習慣 None 毎朝コーヒーを飲むのが習慣です。	custom, habit 毎朝まいあさコーヒーを飲のむのが習慣しゅうかんです。 I'm in the habit of drinking coffee every morning.  2807
研究 Verbal Noun 彼は何年も地震の研究をしている。	research, study 彼かれは何年なんねんも地震じしんの研究けんきゅうをしている。 He's been researching earthquakes for many years.  1054
グラム Noun ひき肉を200グラムください。	gram ひき肉にくを200にひゃくグラムください。 Please give me 200 grams of ground (beef, chicken, etc.)  11670
試験 Verbal Noun 明日の試験、頑張ってね。	exam, test 明日あしたの試験しけん、頑張がんばってね。 Good luck on tomorrow's exam.  3940
問題 Noun 問題が一つあります。	problem, question 問題もんだいが一ひとつあります。 There's one problem.  314
簡単 Adjectival Noun この料理はとても簡単です。	simple, easy この料理りょうりはとても簡単かんたんです。 This dish is very easy to make.  815
複雑 Adjectival Noun このプログラムはとても複雑です。	complicated, intricate このプログラムはとても複雑ふくざつです。 This program is very complicated.  2303
コーヒー Noun 私は毎朝コーヒーを飲みます。	coffee 私わたしは毎朝まいあさコーヒーを飲のみます。 I drink coffee every morning.  1564
数字 Noun 数字は苦手です。	figure, numeral 数字すうじは苦手にがてです。 I'm not good with numbers.  3255
数学 Noun 兄は数学の先生です。	mathematics 兄あには数学すうがくの先生せんせいです。 My big brother's a math teacher.  7234
数える Verb いすの数を数えてください。	to count いすの数かずを数かぞえてください。 Please count the number of chairs.  2881
今回 Noun まあ今回は許してあげよう。	this time まあ今回こんかいは許ゆるしてあげよう。 Well, I'll let you off this time.  1493
テント Noun みんなでテントを張りました。	tent みんなでテントを張はりました。 We all put up the tent together.  4453
回る Verb 月は地球のまわりを回っています。	turn round, go round, detour 月つきは地球ちきゅうのまわりを回まわっています。 The moon spins around the earth.  1168
回す Verb ねじは左に回すと外れます。	turn, rotate ねじは左ひだりに回まわすと外はずれます。 If you turn the screw to the left it will come undone.  1951
個人 Noun これは私個人の意見です。	individual, personal これは私わたし個人こじんの意見いけんです。 This is my personal opinion.  2009
担当 Verbal Noun 私はセールスを担当しています。	in charge (of something) 私わたしはセールスを担当たんとうしています。 I'm in charge of sales.  2423
ボート Noun 池でボートに乗りました。	row boat, boat 池いけでボートに乗のりました。 I got on the boat at the pond.  3106
当たる Verb ボールが彼の頭に当たった。	hit, strike ボールが彼かれの頭あたまに当あたった。 The ball hit him on the head.  1596
当時 Noun 彼女は当時、まだ3才だった。	at that time 彼女かのじょは当時とうじ、まだ3才さんさいだった。 She was only three years old at the time.  666
本当 Noun その話は本当ですか。	truth, reality, genuine その話はなしは本当ほんとうですか。 Is the story true?  816
当然 Adjectival Noun 彼女が怒るのも当然だ。	naturally, of course 彼女かのじょが怒おこるのも当然とうぜんだ。 It's natural that she should be angry.  575
ボール Noun 彼はボールを投げた。	ball 彼かれはボールを投なげた。 He threw the ball.  3363
全然 Adverb この本は全然面白くなかった。	(not) at all, totally (not) この本ほんは全然ぜんぜん面白おもしろくなかった。 This book wasn't interesting at all.  1352
方法 Noun いい方法を思いつきました。	way, method, procedure いい方法ほうほうを思おもいつきました。 We hit on a good method.  839
法律 Noun 新しい法律ができた。	law 新あたらしい法律ほうりつができた。 A new law has been passed.  4409
規則 Noun あの会社の規則は厳しいです。	rule, regulation あの会社かいしゃの規則きそくは厳きびしいです。 That company's rules are strict.  6828
オートバイ Noun 彼はオートバイに乗っている。	motorbike, motorcycle 彼かれはオートバイに乗のっている。 He rides a motorcycle.  12098
経験 Verbal Noun 今日の試合はいい経験になりました。	experience 今日きょうの試合しあいはいい経験けいけんになりました。 Today's game was a good experience.  1144
経つ Verb あれから14年が経ちました。	pass, elapse あれから14年じゅうよねんが経たちました。 Fourteen years have passed since then.  1779
経済 Noun 大学で経済を勉強しました。	economy, economics 大学だいがくで経済けいざいを勉強べんきょうしました。 I studied economics in college.  3852
経営 Verbal Noun 我が社の経営はうまくいっています。	management, operation 我わが社しゃの経営けいえいはうまくいっています。 Our company is well managed.  3235
ひどい Adjective 妹とひどい喧嘩をした。	terrible, cruel 妹いもうととひどい喧嘩けんかをした。 I had an awful fight with my little sister.  430
株 Noun 最近株を始めました。	stocks, shares 最近さいきん株かぶを始はじめました。 I recently started investing in stocks.  5970
企業 Noun 彼女はアメリカの企業で働いています。	business, corporation 彼女かのじょはアメリカの企業きぎょうで働はたらいています。 She works in an American company.  4239
作業 Verbal Noun 作業するにはもっと広いスペースが必要だ。	work, operation 作業さぎょうするにはもっと広ひろいスペースが必要ひつようだ。 I need a bigger space to work.  1575
産業 Noun 日本の自動車産業は世界的に有名だ。	industry 日本にほんの自動車じどうしゃ産業さんぎょうは世界的せかいてきに有名ゆうめいだ。 The Japanese auto industry is famous worldwide.  6813
あなた Noun この本、あなたにあげます。	you この本ほん、あなたにあげます。 I'll give you this book.  118
工業 Noun そこは工業都市だ。	manufacturing industry そこは工業こうぎょう都市としだ。 That's an industrial city.  10336
商業 Noun この町では商業が盛んだ。	business, commerce この町まちでは商業しょうぎょうが盛さかんだ。 Business is thriving in this city.  13385
利用 Verbal Noun 私はよく図書館を利用します。	utilization, usage 私わたしはよく図書館としょかんを利用りようします。 I often use the library.  1441
便利 Adjectival Noun インターネットはとても便利です。	convenience, handiness インターネットはとても便利べんりです。 The Internet is very convenient.  5306
スイッチ Noun 彼はカーラジオのスイッチを入れた。	switch 彼かれはカーラジオのスイッチを入いれた。 He hit the switch on his car radio.  3204
技術 Noun 彼は非常に高い技術を持っている。	skill, technology 彼かれは非常ひじょうに高たかい技術ぎじゅつを持もっている。 He has very advanced skills.  1885
手術 Verbal Noun 父は胸の手術をした。	surgical operation 父ちちは胸むねの手術しゅじゅつをした。 My father had a chest operation.  3449
製造 Verbal Noun この工場ではエアコンを製造しています。	production, manufacture この工場こうじょうではエアコンを製造せいぞうしています。 This factory manufactures air conditioning units.  7057
必ず Adverb 必ずシートベルトを着けて下さい。	without fail, certainly 必かならずシートベルトを着つけて下ください。 Always wear your seat belt.  996
プレゼント Verbal Noun 誕生日にプレゼントをもらいました。	present, gift 誕生日たんじょうびにプレゼントをもらいました。 I got some presents on my birthday.  5492
必要 Adjectival Noun 私にはたくさんのお金が必要だ。	need, necessity 私わたしにはたくさんのお金かねが必要ひつようだ。 I need a lot of money.  279
重要 Adjectival Noun これは重要な書類です。	important, essential これは重要じゅうような書類しょるいです。 This is an important document.  1582
要求 Verbal Noun 彼は私の要求にこたえた。	requirement, demand 彼かれは私わたしの要求ようきゅうにこたえた。 He answered my demands.  1746
目覚まし時計 Noun 7時に目覚まし時計が鳴りました。	alarm clock 7時しちじに目覚めざまし時計どけいが鳴なりました。 The alarm clock went off at seven o'clock.  30129
いつでも Adverb いつでもうちに来てください。	at any time, always いつでもうちに来きてください。 Please come to my house any time. 
計算 Verbal Noun その計算は間違っている。	calculation その計算けいさんは間違まちがっている。 That calculation is wrong.  2399
引き算 Verbal Noun 娘は学校で引き算を習っている。	subtraction 娘むすめは学校がっこうで引ひき算ざんを習ならっている。 My daughter's learning subtraction at school.  55415
足し算 Verbal Noun 娘は学校で足し算を習った。	addition 娘むすめは学校がっこうで足たし算ざんを習ならった。 My daughter learned addition in school.  51834
交差点 Noun 次の交差点を左に曲がってください。	intersection, crossing 次つぎの交差点こうさてんを左ひだりに曲まがってください。 Please turn left at the next intersection.  9611
テニス Verbal Noun 彼らはよくテニスをしています。	tennis 彼かれらはよくテニスをしています。 They often play tennis.  13046
割る Verb 皿を落として割った。	divide (st), crack, split 皿さらを落おとして割わった。 I dropped the plate and broke it.  2520
割れる Verb コップが落ちて割れた。	(st) cracks, splits, breaks (が) コップが落おちて割われた。 The glass fell and broke.  3400
割り算 Verbal Noun 割り算は小学校で習います。	division 割わり算ざんは小学校しょうがっこうで習ならいます。 Division is learned in elementary school.  84451
残る Verb 料理がたくさん残りました。	remain, be left over 料理りょうりがたくさん残のこりました。 A lot of food was left over.  394
こちら Noun 受付はこちらです。	here, this way 受付うけつけはこちらです。 The reception desk is this way.  338
残す Verb 彼女はメッセージを残しました。	leave, reserve, leave undone 彼女かのじょはメッセージを残のこしました。 She left a message.  629
返す Verb 図書館に本を返した。	return, repay 図書館としょかんに本ほんを返かえした。 I returned the book to the library.  659
返事 Verbal Noun 手紙の返事を出しました。	answer, reply 手紙てがみの返事へんじを出だしました。 I sent a reply to the letter.  741
借りる Verb 彼にビデオを借りました。	borrow 彼かれにビデオを借かりました。 I borrowed a video from him.  1195
ボタン Noun ボタンを押してください。	button ボタンを押おしてください。 Please press the button.  2770
貸す Verb 私は彼に本を貸しています。	lend, rent 私わたしは彼かれに本ほんを貸かしています。 I'm lending him the book.  1689
貸し出す Verb その本は貸し出し中です。	lend out (used for businesses/banks) その本ほんは貸かし出だし中ちゅうです。 That book is currently on loan.  46186
申し込む Verb 彼女はそのセミナーに申し込んだ。	apply for, make a proposal 彼女かのじょはそのセミナーに申もうし込こんだ。 She registered for that workshop.  11078
期待 Verbal Noun みんな私たちに期待しています。	expectation, anticipation みんな私わたしたちに期待きたいしています。 Everyone has high expectations of us.  1188
おかしい Adjective 彼の話はおかしかった。	funny, amusing, comical 彼かれの話はなしはおかしかった。 His story was funny.  772
期間 Noun テスト期間は10日から15日までだ。	period (of time) テスト期間きかんは10日とおかから15日じゅうごにちまでだ。 The test period is from the 10th to the 15th.  4667
時期 Noun 今はあなたにとって大事な時期です。	time, period, season 今いまはあなたにとって大事だいじな時期じきです。 It's an important time for you now.  1651
限る Verb このサービスは週末に限ります	be limited to このサービスは週末しゅうまつに限かぎります This service is limited to weekends.  1594
急ぐ Verb 私たちは駅へ急ぎました。	hurry, hasten 私わたしたちは駅えきへ急いそぎました。 We hurried to the station.  857
コート Noun 新しいコートでテニスをしました。	(tennis) court 新あたらしいコートでテニスをしました。 I played tennis on the new court.  2811
急に Adverb 急に用事を思い出した。	suddenly, unexpectedly 急きゅうに用事ようじを思おもい出だした。 I suddenly remembered I have something to do.  59483
急 Adjectival Noun 急な坂道を上った。	urgent, sudden, steep 急きゅうな坂道さかみちを上のぼった。 I went up the steep hill.  525
急行 Noun ちょうど急行電車が来た。	express train, going in a hurry ちょうど急行きゅうこう電車でんしゃが来きた。 The express train just came.  8803
切れる Verb このはさみはよく切れますね。	run out, expire このはさみはよく切きれますね。 These scissors cut well.  1211
ドラマ Noun 私はドラマを見るのが好きです。	drama, theater, soap opera 私わたしはドラマを見みるのが好すきです。 I like to watch TV dramas.  6153
切手 Noun 郵便局で切手を買いました。	postage stamp 郵便局ゆうびんきょくで切手きってを買かいました。 I bought a stamp at the post office.  15403
売り切れる Verb その本は直ぐ売り切れた。	be sold out, go out of stock その本ほんは直すぐ売うり切きれた。 The book sold out quickly.  39733
売り切れ Noun チケットはもう売り切れだって。	sold out チケットはもう売うり切きれだって。 The tickets have sold out already.  59086
大切 Adjectival Noun これは母が大切にしていた指輪です。	important, valuable これは母ははが大切たいせつにしていた指輪ゆびわです。 This is a ring that meant a lot to my mother.  1813
ビザ Noun 学生ビザを持っています。	visa 学生がくせいビザを持もっています。 He has a student visa.  30430
切符 Noun 東京までの切符を買った。	ticket 東京とうきょうまでの切符きっぷを買かった。 I bought a ticket to Tokyo.  6392
入場券 Noun 入場券は3000円です。	entrance ticket 入場券にゅうじょうけんは3000円さんぜんえんです。 The admission ticket is 3,000 yen.  36062
家賃 Noun ここの家賃は12万円です。	rent (money) ここの家賃やちんは12万円じゅうにまんえんです。 The rent here is 120,000 yen.  10267
時代 Noun 今は便利さとスピードの時代だ。	age, era, antiquity 今いまは便利べんりさとスピードの時代じだいだ。 This is the age of convenience and speed.  511
ポケット Noun 財布をポケットにしまった。	pocket 財布さいふをポケットにしまった。 I put my wallet in my pocket.  1126
代わる Verb 上司に代わって会議に出た。	take (st/sb's) place, substitute for 上司じょうしに代かわって会議かいぎに出でた。 I attended the conference in place of my boss.  4884
代える Verb 社長に代えて部長を出席させます。	replace (O1を) with (O2に), substitute 社長しゃちょうに代かえて部長ぶちょうを出席しゅっせきさせます。 I'll have the department manager attend in place of the president.  12705
指 Noun 彼は指が太い。	finger, toe 彼かれは指ゆびが太ふとい。 His fingers are fat.  578
決定 Verbal Noun 会議で重要な決定がありました。	decision 会議かいぎで重要じゅうような決定けっていがありました。 An important decision was made at the conference.  2533
そろそろ Adverb そろそろ始めましょうか。	soon, slowly, gingerly そろそろ始はじめましょうか。 It's about time to begin.  1478
一定 Verbal Noun 申し込むには一定の資格が要る。	constant, fixed 申もうし込こむには一定いっていの資格しかくが要いる。 You need certain qualifications to apply.  5562
定期券 Noun 定期券は1万2千円でした。	commuter pass 定期券ていきけんは1万2千円いちまんにせんえんでした。 The commuter pass was 1,2000 yen.  40273
予定 Verbal Noun 今日の予定を教えてください。	schedule, plan 今日きょうの予定よていを教おしえてください。 Please tell me what your schedule is for today.  1755
天気予報 Noun 明日の天気予報は雨です。	weather forecast 明日あしたの天気予報てんきよほうは雨あめです。 Rain is forecast for tomorrow.  21544
ぶどう Noun 私はぶどうが好きです。	grapes 私わたしはぶどうが好すきです。 I like grapes.  18026
予習 Verbal Noun 明日の予習をしましょう。	preparation for class 明日あしたの予習よしゅうをしましょう。 Let's prepare for tomorrow.  38466
予約 Verbal Noun レストランを予約しました。	reservation, subscription, appointment レストランを予約よやくしました。 I made a reservation at the restaurant.  7011
約束 Verbal Noun 約束は守ります。	promise, vow 約束やくそくは守まもります。 I keep my promises.  773
変わる Verb 信号が青に変わりました。	change が 信号しんごうが青あおに変かわりました。 The traffic light turned green.  501
めったに Adverb 彼女はめったに怒りません。	rarely 彼女かのじょはめったに怒おこりません。 She rarely gets angry.  4581
大変 Adjectival Noun 大変なことが起こりました。	awful, serious 大変たいへんなことが起おこりました。 A terrible thing happened.  874
変 Adjectival Noun 変な音が聞こえます。	strange, weird, funny 変へんな音おとが聞きこえます。 I hear a strange sound.  947
変化 Verbal Noun 今年は変化の多い年でした。	change 今年ことしは変化へんかの多おおい年としでした。 There was a lot of change this year.  1225
強化 Verbal Noun 国は国語教育を強化しています。	strengthening 国くには国語教育こくご きょういくを強化きょうかしています。 Our government is strengthening its program in native language education.  6294
クリスマス Noun クリスマスにはケーキを食べます。	Christmas クリスマスにはケーキを食たべます。 We eat cake at Christmas.  4731
文化 Noun 私はこの国の文化を勉強しています。	culture 私わたしはこの国くにの文化ぶんかを勉強べんきょうしています。 I'm studying this country's culture.  1900
増える Verb この町は人口が増えた。	increase, accrue が この町まちは人口じんこうが増ふえた。 The population has increased in this town.  2527
増やす Verb あの町は緑を増やしています。	increase (something), add を あの町まちは緑みどりを増ふやしています。 That town is increasing its greenery.  9722
減る Verb 体重がかなり減りました。	decrease, diminish が 体重たいじゅうがかなり減へりました。 I've lost a lot of weight.  3009
ネクタイ Noun 父の日にネクタイをプレゼントした。	tie, necktie 父ちちの日ひにネクタイをプレゼントした。 I gave him a tie on Father's Day.  4862
減らす Verb 最近、食事を減らしています。	decrease (something), reduce を 最近さいきん、食事しょくじを減へらしています。 I've been eating less recently.  10589
乗り物 Noun 自転車は便利な乗り物です。	vehicle, means of transportation 自転車じてんしゃは便利べんりな乗のり物ものです。 Bicycles are a convenient form of transport.  17056
降りる Verb 次の駅で降ります。	get off, land 次つぎの駅えきで降おります。 I get off at the next station.  684
降ろす Verb 彼は車から荷物を降ろした。	unload, lower 彼かれは車くるまから荷物にもつを降おろした。 He unloaded the luggage from the car.  5955
バイオリン Noun 彼女はバイオリンを習っています。	violin 彼女かのじょはバイオリンを習ならっています。 She's learning the violin.  23019
降る Verb 激しい雨が降っています。	fall, come down, rain 激はげしい雨あめが降ふっています。 A very heavy rain is falling.  1417
着く Verb 午後8時に大阪に着きます。	arrive, touch, take one's place 午後8時ごご はちじに大阪おおさかに着つきます。 I arrive in Osaka at 8:00 pm.  775
着物 Noun 彼女は着物がよく似合います。	kimono, clothes 彼女かのじょは着物きものがよく似合にあいます。 She looks good in a kimono.  1986
下着 Noun 私は下着を手で洗う。	underwear 私わたしは下着したぎを手てで洗あらう。 I wash my underwear by hand.  3959
パスポート Noun パスポートが見つからない。	passport パスポートが見みつからない。 I can't find my passport.  12345
上着 Noun 暑いので上着を脱ぎました。	outerwear 暑あついので上着うわぎを脱ぬぎました。 I took my jacket off because it was hot.  3819
着せる Verb 娘にかわいいドレスを着せた。	dress (sb), put clothes on (sb) 娘むすめにかわいいドレスを着きせた。 I dressed my daughter in a cute dress.  4907
脱ぐ Verb 靴を脱いでください。	remove clothes, take off 靴くつを脱ぬいでください。 Please take off your shoes.  1729
立場 Noun 彼女は自分の立場を分かっていない。	standpoint, position 彼女かのじょは自分じぶんの立場たちばを分わかっていない。 She doesn't understand her position.  1221
バッグ Noun 私は黒いバッグを持っています。	bag 私わたしは黒くろいバッグを持もっています。 I have a black bag.  3208
目立つ Verb 彼女の大きな帽子はとても目立つ。	stand out, be conspicuous 彼女かのじょの大おおきな帽子ぼうしはとても目立めだつ。 Her big hat really stands out.  2282
立てる Verb 彼はケーキにろうそくを立てた。	stand (sth) up, set (sth) up, establish 彼かれはケーキにろうそくを立たてた。 He stuck the candles into the cake.  507
役に立つ Verb 私は人々の役に立ちたいと思っています。	be useful, be helpful 私わたしは人々ひとびとの役やくに立たちたいと思おもっています。 I want to be of service to others.  2642
出席 Verbal Noun 午後は会議に出席します。	attendance, presence 午後ごごは会議かいぎに出席しゅっせきします。 I'll attend a meeting in the afternoon.  4382
ゴム Noun ゴムが伸びてしまった。	rubber, elastic ゴムが伸のびてしまった。 The elastic has gone loose.  6578
席 Noun この席、空いてますか。	seat, one's place この席せき、空あいてますか。 Is this seat free?  734
欠席 Verbal Noun 風邪のため、今日は欠席します。	absence, non-attendance 風邪かぜのため、今日きょうは欠席けっせきします。 I'll be absent today because of a cold.  16576
次男 Noun 次男は今、海外にいます。	second son 次男じなんは今いま、海外かいがいにいます。 My second son is abroad now.  7913
次女 Noun うちの次女は春から中学生です。	second daughter うちの次女じじょは春はるから中学生ちゅうがくせいです。 Our second daughter is going into junior high this spring.  19481
ギター Noun 彼女はギターが得意です。	guitar 彼女かのじょはギターが得意とくいです。 She's good at the guitar.  9606
運ぶ Verb いすを二階に運んでください。	carry, transport いすを二階にかいに運はこんでください。 Please carry the chair to the second floor.  628
運転 Verbal Noun 父は安全運転だ。	drive 父ちちは安全あんぜん運転うんてんだ。 My father drives safely.  2801
運転手 Noun 彼はタクシーの運転手です。	driver 彼かれはタクシーの運転手うんてんしゅです。 He's a taxi driver.  2184
転ぶ Verb お祖母ちゃんがお風呂場で転んだ。	tumble down, fall over お祖母ばあちゃんがお風呂場ふろばで転ころんだ。 My grandma fell down in the bathroom.  5733
セーター Noun このセーターはウールだ。	sweater, pullover このセーターはウールだ。 This sweater is made of wool.  6879
移る Verb 彼女は新しい会社に移った。	move, shift が 彼女かのじょは新あたらしい会社かいしゃに移うつった。 She moved to a new company.  1667
移す Verb 机を窓のそばに移しました。	move (something), shift, transfer 机つくえを窓まどのそばに移うつしました。 I moved the desk near the window.  2081
動き Noun まず相手の動きを見ましょう。	movement, motion まず相手あいての動うごきを見みましょう。 First, watch your opponent's moves.  876
運動 Verbal Noun 彼はもっと運動した方がいい。	exercise, movement 彼かれはもっと運動うんどうした方ほうがいい。 He should exercise more.  2340
やっぱり Adverb やっぱり旅が大好きだ。	just as I thought, after all やっぱり旅たびが大好だいすきだ。 I just love to travel.  582
活動 Verbal Noun 彼は地域の活動に参加した。	activity 彼かれは地域ちいきの活動かつどうに参加さんかした。 He took part in local activities.  2105
動物 Noun 私は動物が大好きです。	animal 私わたしは動物どうぶつが大好だいすきです。 I love animals.  1609
動かす Verb 部屋の家具を動かしました。	move (something), operate 部屋へやの家具かぐを動うごかしました。 I moved the furniture in the room.  866
不動産屋 Noun 私の父は不動産屋です。	real estate agent, realtor 私わたしの父ちちは不動産屋ふどうさんやです。 My father's a real estate agent.  15511
カーテン Noun 朝、カーテンを開けた。	curtain 朝あさ、カーテンを開あけた。 I opened the curtains in the morning.  2528
早く Adverb なるべく早く来て下さい。	early, soon なるべく早はやく来きて下ください。 Please come as early as possible.  32424
早口 Noun 彼女は早口だ。	fast talking 彼女かのじょは早口はやくちだ。 She talks quickly.  5779
速さ Noun 新幹線の速さはどれぐらいですか。	speed 新幹線しんかんせんの速はやさはどれぐらいですか。 How fast is the bullet train?  117780
速達 Noun これを速達で送りたいのですが。	express mail これを速達そくたつで送おくりたいのですが。 I want to send this by express mail.  27275
シャツ Noun このシャツはアイロンが必要だ。	shirt このシャツはアイロンが必要ひつようだ。 This shirt needs ironing.  2826
遅れる Verb 今朝彼女は学校に遅れました。	be late 今朝彼女けさ かのじょは学校がっこうに遅おくれました。 She was late for school this morning.  2114
開始 Verbal Noun 運動会は9時開始です。	beginning 運動会うんどうかいは9時くじ開始かいしです。 The athletic meet begins at nine o'clock.  2235
始めに Adverb 始めにスープが出ます。	in the beginning 始はじめにスープが出でます。 Soup is served first. 
現在 Noun 現在の気温は30度です。	the present, present time 現在げんざいの気温きおんは30度さんじゅうどです。 The current temperature is 30 degrees.  820
ナイフ Noun ナイフで手を切った。	knife ナイフで手てを切きった。 I cut my hand with a knife.  1646
実現 Verbal Noun 夢を実現するには努力が必要です。	realization, fulfillment 夢ゆめを実現じつげんするには努力どりょくが必要ひつようです。 You need to make an effort to make your dreams come true.  3495
実施 Verbal Noun 現在、スペシャルキャンペーンを実施中です。	being in effect, implementation 現在げんざい、スペシャルキャンペーンを実施じっし中ちゅうです。 A special campaign is now under way.  9793
事実 Noun それは全て事実ですか。	fact, truth それは全すべて事実じじつですか。 Is it all true?  498
実行 Verbal Noun 彼はその計画を実行した。	(putting into) practice, execution 彼かれはその計画けいかくを実行じっこうした。 He executed the plan.  2682
バイク Noun 兄はバイクが大好きです。	motorcycle 兄あにはバイクが大好だいすきです。 My older brother loves motorcycles.  6262
実験 Verbal Noun 科学の授業で実験をした。	experiment 科学かがくの授業じゅぎょうで実験じっけんをした。 We did an experiment in science class.  3041
通過 Verbal Noun 次の駅は通過します。	passing, passage 次つぎの駅えきは通過つうかします。 This train will not stop at the next station.  3666
過ぎる Verb 時が過ぎるのは速い。	pass by, exceed 時ときが過すぎるのは速はやい。 Time passes quickly.  583
昼過ぎ Noun 彼は昼過ぎに来ます。	just past noon 彼かれは昼過ひるすぎに来きます。 He'll come after lunch.  14591
いつか Adverb 僕はいつかアフリカに行きたい。	some time, some day 僕ぼくはいつかアフリカに行いきたい。 I want to go to Africa some time.  1230
過去 Noun それは過去の話だ。	the past それは過去かこの話はなしだ。 That's in the past now.  1307
開発 Verbal Noun ダムの開発に住民は反対しています。	development ダムの開発かいはつに住民じゅうみんは反対はんたいしています。 The residents are against the development of the dam.  2798
発生 Verbal Noun 交差点で事故が発生した。	occurrence, happening 交差点こうさてんで事故じこが発生はっせいした。 There was an accident at the intersection.  2318
発言 Verbal Noun 会議で全員が発言した。	statement, remark 会議かいぎで全員ぜんいんが発言はつげんした。 Everyone spoke at the conference.  3129
オレンジ Noun 私はオレンジが好きです。	orange 私わたしはオレンジが好すきです。 I like oranges.  9985
発見 Verbal Noun 新しい星が発見された。	discovery, revelation 新あたらしい星ほしが発見はっけんされた。 A new star was discovered.  751
出発 Verbal Noun あと15分で出発です。	departure, starting あと15分じゅうごふんで出発しゅっぱつです。 Departure will be in fifteen minutes.  1476
発車 Verbal Noun バスが発車します。	depart, leave (for vehicles) バスが発車はっしゃします。 The bus is leaving.  11086
発表 Verbal Noun 合格者が発表された。	announcement 合格者ごうかくしゃが発表はっぴょうされた。 Those who passed were announced.  1893
きつい Adjective このシャツは少しきついです。	tight, difficult このシャツは少すこしきついです。 This shirt is a little tight.  2923
表現 Verbal Noun 彼は歌で自分の気持ちを表現した。	expression (of views, feelings, etc.) 彼かれは歌うたで自分じぶんの気持きもちを表現ひょうげんした。 He expressed his feelings in song.  1537
代表 Verbal Noun 彼がクラスの代表だ。	representative 彼かれがクラスの代表だいひょうだ。 He's the class representative.  2635
表 Noun 表に人が来ています。	front side, face, outside 表おもてに人ひとが来きています。 Someone has come to the door.  1410
表 Noun この表を見てください。	list, table この表ひょうを見みてください。 Please look at this chart.  1410
さっき Adverb さっきの話を続けましょう。	some time ago, only a moment ago さっきの話はなしを続つづけましょう。 Let's continue the conversation we had earlier.  495
手紙 Noun 友人から手紙をもらいました。	letter 友人ゆうじんから手紙てがみをもらいました。 I got a letter from a friend.  509
絵 Noun これは有名な画家の絵です。	picture, painting, drawing これは有名ゆうめいな画家がかの絵えです。 This is a painting by a famous painter.  778
雑誌 Noun この雑誌はよく売れています。	magazine, journal この雑誌ざっしはよく売うれています。 This magazine sells well.  1688
音 Noun 雨の音が聞こえる。	sound, noise 雨あめの音おとが聞きこえる。 I can hear the sound of rain.  186
テキスト Noun テキストを読んでください。	textbook, text file テキストを読よんでください。 Please read the textbook.  14868
音 Noun このピアノは音があまり良くない。	sound このピアノは音おとがあまり良よくない。 That piano's sound isn't very good.  186
音楽 Noun 私は音楽を聞くのが好きだ。	music 私わたしは音楽おんがくを聞きくのが好すきだ。 I like to listen to music.  1568
薬 Noun この薬を必ず飲んでください。	drug, remedy, chemical この薬くすりを必かならず飲のんでください。 Please be sure to take this medicine.  1435
歌 Noun 私はその歌を知らなかった。	song 私わたしはその歌うたを知しらなかった。 I didn't know that song.  805
ビニール袋 Noun ゴミはそのビニール袋に入れてください。	plastic bag ゴミはそのビニール袋ぶくろに入いれてください。 Please put trash in that plastic bag.  12519
歌手 Noun その歌手は歌が下手だ。	singer その歌手かしゅは歌うたが下手へただ。 That singer's terrible.  7818
欲しがる Verb 子供がジュースを欲しがっています。	want (describing sb else) 子供こどもがジュースを欲ほしがっています。 My kid wants some juice. 
計画 Verbal Noun 彼は一人旅の計画を立てた。	plan, project 彼かれは一人旅ひとりたびの計画けいかくを立たてた。 He planned a journey alone.  1033
映画 Noun 彼はよく映画を見ます。	movie 彼かれはよく映画えいがを見みます。 He often watches movies.  1190
りんご Noun りんごを一つください。	apple りんごを一ひとつください。 Please give me one of the apples.  16818
面白い Adjective この本は全然面白くなかった。	interesting, amusing この本ほんは全然ぜんぜん面白おもしろくなかった。 This book wasn't interesting at all.  893
写る Verb このカメラはよく写りますよ。	to appear in a photo, (picture) to come out well このカメラはよく写うつりますよ。 This camera takes good pictures.  6756
写す Verb 彼は友達の答えを写した。	copy, photograph 彼かれは友達ともだちの答こたえを写うつした。 He copied down his friend's answers.  7101
写真 Noun 写真は良い思い出になります。	photograph 写真しゃしんは良いい思おもい出でになります。 Photographs make a good souvenir.  661
アルバム Noun 私は彼のアルバムを見た。	album 私わたしは彼かれのアルバムを見みた。 I saw his album.  10074
真っ赤 Adjectival Noun 彼の顔は真っ赤でした。	deep red 彼かれの顔かおは真まっ赤かでした。 His face was red.  2982
真面目 Adjectival Noun 彼は真面目な人です。	serious, sober, earnest 彼かれは真面目まじめな人ひとです。 He's a serious-minded person.  2957
真ん中 Noun 道の真ん中に人が立っている。	center, middle 道みちの真まん中なかに人ひとが立たっている。 Someone is standing in the middle of the road.  3705
真っ白 Adjectival Noun 外は雪で真っ白だった。	pure-white 外そとは雪ゆきで真まっ白しろだった。 Everything outside was white with snow.  5829
スカート Noun 彼女はあまりスカートははかない。	skirt 彼女かのじょはあまりスカートははかない。 She doesn't wear skirts very often.  3343
真っ暗 Adjectival Noun 外は真っ暗です。	pitch-dark 外そとは真まっ暗くらです。 It's pitch-dark outside.  6567
真っ黒 Adjectival Noun インクで手が真っ黒になった	deep-black, jet-black インクで手てが真まっ黒くろになった My hands got all black with ink.  8388
真っ青 Adjectival Noun 空が真っ青です。	deep-blue, pale (skin) 空そらが真まっ青さおです。 The sky is bright blue.  10542
色々 Adjectival Noun 彼は色々なことを知っている。	various 彼かれは色々いろいろなことを知しっている。 He knows about a lot of things.  2864
ペン Noun ペンを貸してください。	pen ペンを貸かしてください。 Please lend me the pen.  5393
人形 Noun 彼女は人形をたくさん持っています。	doll 彼女かのじょは人形にんぎょうをたくさん持もっています。 She has a lot of dolls.  1645
形 Noun その椅子は変わった形をしている。	shape, form その椅子いすは変かわった形かたちをしている。 That chair has an unusual shape.  519
大型 Noun 大型のテレビを買った。	large, large scale 大型おおがたのテレビを買かった。 We bought a large television.  4392
種類 Noun バラには色々な種類があります。	kind, variety, species バラには色々いろいろな種類しゅるいがあります。 There are many varieties of rose.  2226
おしゃべり Verbal Noun 妹はとてもおしゃべりです。	chatter, talkative 妹いもうとはとてもおしゃべりです。 My little sister's very talkative.  4842
直す Verb 私がそれを直しました。	repair, cure, alter 私わたしがそれを直なおしました。 I mended it.  1455
真っ直ぐ Adverb この道を真っ直ぐ行ってください。	dead straight, honestly この道みちを真まっ直すぐ行いってください。 Please go straight along this road.  8147
直接 Adverb 彼に直接お願いしなさい。	directly 彼かれに直接ちょくせつお願ねがいしなさい。 Ask him directly.  1491
角 Noun 次の角で左に曲がってください。	corner, edge, angle 次つぎの角かどで左ひだりに曲まがってください。 Please turn left at the next corner.  1358
きっと Adverb 明日はきっと雨が降ります。	surely, certainly 明日あしたはきっと雨あめが降ふります。 I'm sure it'll rain tomorrow.  450
三角 Noun 紙を三角に切りました。	triangle 紙かみを三角さんかくに切きりました。 I cut the paper into a triangle.  10769
四角 Adjectival Noun 紙を四角に切ってください。	square, quadrilateral 紙かみを四角しかくに切きってください。 Please cut the paper into a square.  12324
四角い Adjective こっちの四角いテーブルを買おうよ。	square, four-sided こっちの四角しかくいテーブルを買かおうよ。 Let's buy this square table over here.  6802
四つ角 Noun あそこの四つ角を左に曲がってください。	street corner, intersection あそこの四よつ角かどを左ひだりに曲まがってください。 Please turn left at that crossroad up there.  40997
メニュー Noun メニューをください。	menu, bill of fare メニューをください。 Please give me the menu.  7660
曲 Noun 私はこの曲が大好きです。	song, melody, tune 私わたしはこの曲きょくが大好だいすきです。 I love this song.  1557
曲げる Verb ひざを曲げてください。	bend, curve ひざを曲まげてください。 Please bend your knees.  4689
曲がり角 Noun ポストはそこの曲がり角にあります。	street corner ポストはそこの曲まがり角かどにあります。 There's a post box on that corner.  18547
同様 Adjectival Noun 私たちは彼を家族同様に思っている。	similar, same 私わたしたちは彼かれを家族かぞく同様どうように思おもっている。 We think of him just like family.  1311
アイスクリーム Noun 弟はアイスクリームが大好きです。	ice cream 弟おとうとはアイスクリームが大好だいすきです。 My little brother loves ice cream.  12533
間違い Noun この文には間違いがあります。	mistake, error この文ぶんには間違まちがいがあります。 There's a mistake in this sentence.  1209
間違える Verb 電話番号を間違えました。	make a mistake (in something), confuse (を) 電話番号でんわ ばんごうを間違まちがえました。 I called the wrong number.  4641
間違う Verb あなたは間違っている。	be mistaken, be incorrect あなたは間違まちがっている。 You're mistaken.  2749
似ている Verb 私は母に似ています。	look like, resemble 私わたしは母ははに似にています。 I look like my mother. 
おしゃれ Verbal Noun あの子はおしゃれだね。	dressing up, trendy あの子こはおしゃれだね。 That girl is trendy.  14089
以上 Noun 飛行機が1時間以上遅れた。	more than, not less than 飛行機ひこうきが1時間いちじかん以上いじょう遅おくれた。 The plane arrived over an hour late.  251
旅行 Verbal Noun 彼女は旅行が好きです。	travel, trip 彼女かのじょは旅行りょこうが好すきです。 She likes traveling.  1589
大使館 Noun 彼は大使館に勤めています。	embassy 彼かれは大使館たいしかんに勤つとめています。 He's working for the embassy.  9270
旅館 Noun 京都では旅館に泊まりました。	Japanese inn 京都きょうとでは旅館りょかんに泊とまりました。 I stayed at an inn in Kyoto.  3321
ジュース Noun このジュースは甘すぎる。	juice, soft drink このジュースは甘あますぎる。 This juice is too sweet.  8151
映画館 Noun 彼と近くの映画館に行きました。	movie theater 彼かれと近ちかくの映画館えいがかんに行いきました。 I went to a nearby movie theater with him.  8950
宿題 Noun 友達と一緒に宿題をした。	homework 友達ともだちと一緒いっしょに宿題しゅくだいをした。 I did my homework with a friend.  10531
泊める Verb 友達をうちに泊めてあげました。	lodge, give shelter 友達ともだちをうちに泊とめてあげました。 I put my friend up at my house.  8536
遊び Noun お正月には色々な遊びをします。	play, amusement お正月しょうがつには色々いろいろな遊あそびをします。 We play a lot of games at New Year's.  1465
ゼロ Noun 今日の交通事故はゼロです。	zero 今日きょうの交通事故こうつう じこはゼロです。 Today there were zero traffic accidents.  5177
洋服 Noun 今日は洋服を買いに行きます。	clothes 今日きょうは洋服ようふくを買かいに行いきます。 I'm going to buy some clothes today.  5191
教室 Noun 私の教室は3階にあります。	classroom, class 私わたしの教室きょうしつは3階さんがいにあります。 My classroom is on the third floor.  1753
図書室 Noun 図書室で勉強した。	library room 図書室としょしつで勉強べんきょうした。 I studied at the library.  12187
窓 Noun 窓を開けてください。	window, windowpane 窓まどを開あけてください。 Please open the window.  402
ピンク Noun 娘がピンクのドレスを着ている。	pink 娘むすめがピンクのドレスを着きている。 My daughter's wearing a pink dress.  5643
親しい Adjective 週末、親しい友達を家に呼んだ。	intimate, close 週末しゅうまつ、親したしい友達ともだちを家いえに呼よんだ。 I invited a good friend to my house over the weekend.  1979
親切 Adjectival Noun 親切にしてくださってどうもありがとうございます。	kind, friendly 親切しんせつにしてくださってどうもありがとうございます。 Thank you for being so kind to me.  2274
不親切 Adjectival Noun その店員は不親切だった。	unkind, inattentive その店員てんいんは不親切ふしんせつだった。 That store clerk was unkind.  36704
家族 Noun うちは五人家族です。	family, household うちは五人ごにん家族かぞくです。 We're a family of five.  950
グラス Noun これはきれいなグラスですね。	glass これはきれいなグラスですね。 This is a beautiful glass.  1817
万歳 Verbal Noun 勝った、万歳!	Banzai! Hurrah! Long live...! 勝かった、万歳ばんざい! We won--hurray!  15524
二十歳 Noun 妹は来年、二十歳になります。	20 years old 妹いもうとは来年らいねん、二十歳はたちになります。 My little sister will be 20 next year.  7804
姉さん Noun 姉さん、ごめんね。	older sister, girl, miss 姉ねえさん、ごめんね。 I'm sorry sis.  3156
兄さん Noun 兄さん、おめでとう。	older brother 兄にいさん、おめでとう。 Congratulations, big brother.  2047
ダンス Verbal Noun 彼女はダンスが大好きです。	dance, dancing 彼女かのじょはダンスが大好だいすきです。 She loves to dance.  5272
兄弟 Noun 彼は3人兄弟です。	siblings 彼かれは3人さんにん兄弟きょうだいです。 He has two siblings.  1987
業者 Noun 引っ越しを業者に頼んだ。	business man 引ひっ越こしを業者ぎょうしゃに頼たのんだ。 I asked a company to handle my move.  6661
若者 Noun 最近の若者は本を読まない。	young person, youth 最近さいきんの若者わかものは本ほんを読よまない。 Young people these days don't read books.  1129
彼ら Noun 彼らはバスケットの選手です。	they 彼かれらはバスケットの選手せんしゅです。 They're basketball players.  252
おじ Noun おじは銀行に勤めています。	uncle おじは銀行ぎんこうに勤つとめています。 My uncle works for a bank.  7426
結合 Verbal Noun ファイルを結合して1つにしました。	combination, joining ファイルを結合けつごうして1ひとつにしました。 I consolidated the files into just one.  10918
結果 Noun 試合の結果を早く知りたい。	result, outcome 試合しあいの結果けっかを早はやく知しりたい。 I want to know the results of the game soon.  676
果物 Noun デザートに果物を食べましょう。	fruit デザートに果物くだものを食たべましょう。 Let's have fruit for dessert.  6752
課題 Noun 夏休みの課題は何ですか。	task, problem 夏休なつやすみの課題かだいは何なんですか。 What's our summer assignment?  9029
サッカー Noun 彼はサッカーの選手です。	soccer, football 彼かれはサッカーの選手せんしゅです。 He's a soccer player.  9770
課 Noun 今から課のミーティングがある。	section, division, lesson 今いまから課かのミーティングがある。 Our division is going to have a meeting now.  3703
効果 Noun この薬には胃を守る効果がある。	effect, result この薬くすりには胃いを守まもる効果こうかがある。 This medicine is effective in protecting your stomach.  2160
自動車 Noun 彼は自動車会社に就職した。	automobile 彼かれは自動車じどうしゃ会社がいしゃに就職しゅうしょくした。 He got a job at a car company.  2290
自然 Noun みんなで自然を守りましょう。	nature みんなで自然しぜんを守まもりましょう。 Let's all work to protect Nature.  900
スープ Noun 母がコーンスープを作っている。	soup, broth 母ははがコーンスープを作つくっている。 My mother made some corn chowder.  6052
自然 Adjectival Noun 親が子供を守るのは自然なことだ。	natural, naturally 親おやが子供こどもを守まもるのは自然しぜんなことだ。 It's natural that parents protect their children.  900
自習 Verbal Noun 明日は自習の時間がある。	self-study, self-teaching 明日あすは自習じしゅうの時間じかんがある。 I have study time tomorrow.  37115
理由 Noun 遅れた理由を教えてください。	reason, cause 遅おくれた理由りゆうを教おしえてください。 Please tell me why you were late.  449
自由 Adjectival Noun 今日は自由な時間が多い。	freedom, free 今日きょうは自由じゆうな時間じかんが多おおい。 I have a lot of free time today.  1106
バナナ Noun 私は毎朝バナナを食べます。	banana 私わたしは毎朝まいあさバナナを食たべます。 I eat a banana every morning.  11957
信じる Verb 彼はキリストを信じている。	believe, trust, have faith in 彼かれはキリストを信しんじている。 He believes in Christ.  382
信号 Noun 信号が青になった。	signal, traffic light 信号しんごうが青あおになった。 The traffic light turned green.  5322
頼む Verb 私はハンバーガーを頼みました。	ask, request 私わたしはハンバーガーを頼たのみました。 I ordered a hamburger.  622
市民 Noun 市民の安全は大切だ。	citizens, townsmen 市民しみんの安全あんぜんは大切たいせつだ。 The citizens' safety is important.  2941
うるさい Adjective この通りは車の音がうるさい。	noisy, annoying, pesky この通とおりは車くるまの音おとがうるさい。 Traffic is noisy on this street.  2360
住民 Noun 地域の住民が集まって話合いをした。	residents, inhabitants 地域ちいきの住民じゅうみんが集あつまって話合はなしあいをした。 The local residents got together and talked.  4085
主人 Noun 主人は今、留守です。	husband, the head of the house 主人しゅじんは今いま、留守るすです。 My husband is out now.  765
議員 Noun 彼は国会議員です。	legislator 彼かれは国会こっかい議員ぎいんです。 He's a congressman.  6208
会議 Verbal Noun 今日の午後、大事な会議があります。	conference, meeting 今日きょうの午後ごご、大事だいじな会議かいぎがあります。 There's an important meeting this afternoon.  2093
パトカー Noun あそこにパトカーがいる。	police car, patrol car あそこにパトカーがいる。 There's a police car over there.  6540
対する Verb その質問に対する答えが見つからなかった。	in response to, face その質問しつもんに対たいする答こたえが見みつからなかった。 I couldn't find an answer to that question.  20459
対立 Verbal Noun その2社は対立しています。	opposition, antagonism その2社にしゃは対立たいりつしています。 The two companies are against each other.  4889
反対 Verbal Noun 私は反対です。	oppose, the opposite 私わたしは反対はんたいです。 I'm against it.  1316
答え Noun 彼はその問題の答えが分からない。	answer, solution 彼かれはその問題もんだいの答こたえが分わからない。 He doesn't know the answer to the problem.  1495
ハンバーガー Noun 今日の昼ご飯はハンバーガーでした。	hamburger 今日きょうの昼ひるご飯はんはハンバーガーでした。 I had a hamburger for lunch today.  17475
特に Adverb 特に質問はありません。	specially, particularly 特とくに質問しつもんはありません。 I don't particularly have any questions.  1079
特急 Noun 東京まで特急で3時間かかります。	limited express (train) 東京とうきょうまで特急とっきゅうで3時間さんじかんかかります。 It takes three hours to Tokyo by limited express.  13359
特別 Adjectival Noun あなたは私にとって特別な人です。	special, extraordinary あなたは私わたしにとって特別とくべつな人ひとです。 You're special to me.  1369
別々 Adjectival Noun 別々に払いましょう。	separately 別々べつべつに払はらいましょう。 Let's get separate checks.  10218
エスカレーター Noun 3階までエスカレーターで行きましょう。	escalator 3階さんかいまでエスカレーターで行いきましょう。 Let's take the escalator up to the third floor.  23097
別れる Verb 駅で友だちと別れました。	separate, part from 駅えきで友ともだちと別わかれました。 I parted with my friend at the station.  1296
一般 Noun 一般の方はこちらの席へどうぞ。	general, common 一般いっぱんの方かたはこちらの席せきへどうぞ。 General seating is over here.  2154
目的 Noun 彼が来た目的が分かりません。	objective, purpose 彼かれが来きた目的もくてきが分わかりません。 I don't know the purpose of his visit.  912
普通 Adjectival Noun 彼女は普通の女の子だ。	normal, regular 彼女かのじょは普通ふつうの女おんなの子こだ。 She's just a normal girl.  782
タオル Noun 私はタオルで顔をふいた。	towel 私わたしはタオルで顔かおをふいた。 I wiped my face with a towel.  4354
並ぶ Verb ここに並んでください。	line up, be parallel ここに並ならんでください。 Please line up here.  1110
並べる Verb 私は料理をテーブルに並べた。	line (st) up, display, set up 私わたしは料理りょうりをテーブルに並ならべた。 I arranged the food on the table.  2062
平和 Adjectival Noun この国は平和です。	peace, harmony この国くには平和へいわです。 This country is peaceful.  2478
高等学校 Noun 弟が高等学校を卒業しました。	senior high school 弟おとうとが高等学校こうとうがっこうを卒業そつぎょうしました。 My little brother graduated from high school.  17589
パチンコ Noun 彼は毎日パチンコをしています。	pachinko (vertical pinball) 彼かれは毎日まいにちパチンコをしています。 He plays pachinko every day.  10482
病院 Noun 病院はどこですか。	hospital 病院びょういんはどこですか。 Where is the hospital?  803
入院 Verbal Noun 昨日、母が入院しました。	be hospitalized 昨日きのう、母ははが入院にゅういんしました。 My mother was hospitalized yesterday.  3596
大学院 Noun 彼は大学院に進みました。	graduate school 彼かれは大学院だいがくいんに進すすみました。 He's gone on to graduate school.  20286
医者 Noun 私は医者に相談した。	doctor 私わたしは医者いしゃに相談そうだんした。 I consulted the doctor.  1191
みかん Noun みかんを1つください。	tangerine, mandarin orange みかんを1ひとつください。 Please give me a tangerine.  15681
お医者さん Noun 熱があるのでお医者さんに行った。	doctor 熱ねつがあるのでお医者いしゃさんに行いった。 I went to the doctor because I had a fever.  11768
歯医者 Noun 私は歯医者が嫌いです。	dentist 私わたしは歯医者はいしゃが嫌きらいです。 I hate the dentist.  22351
歯 Noun 私の歯は丈夫です。	tooth, cog 私わたしの歯はは丈夫じょうぶです。 My teeth are strong.  1244
歯ブラシ Noun 新しい歯ブラシが必要だ。	toothbrush 新あたらしい歯はブラシが必要ひつようだ。 I need a new toothbrush.  27452
ケーキ Noun 誕生日にケーキを食べました。	cake 誕生日たんじょうびにケーキを食たべました。 We ate cake on his birthday.  6636
科学 Noun 科学は常に進歩している。	science 科学かがくは常つねに進歩しんぽしている。 Science is always advancing.  3270
教科書 Noun 日本語の教科書を忘れた。	textbook, schoolbook 日本語にほんごの教科書きょうかしょを忘わすれた。 I forgot my Japanese textbook.  6846
理科 Noun 私は理科が得意です。	science 私わたしは理科りかが得意とくいです。 I'm good at science.  23303
亡くなる Verb おととい、昔の友人が亡くなった。	die, pass away おととい、昔むかしの友人ゆうじんが亡なくなった。 An old friend died the day before yesterday.  1903
コップ Noun 私は毎朝コップ一杯の水を飲む。	cup, glass 私わたしは毎朝まいあさコップ一杯いっぱいの水みずを飲のむ。 I drink a glass of water every morning.  3624
忙しい Adjective 忙しいので手伝ってください。	busy, occupied 忙いそがしいので手伝てつだってください。 I have a lot to do, so please help me out.  1833
疲れる Verb 私は疲れてふらふらです。	get tired, become fatigued 私わたしは疲つかれてふらふらです。 I'm tired and feel dizzy.  1158
禁煙 Verbal Noun 彼は今、禁煙しています。	no smoking, giving up smoking 彼かれは今いま、禁煙きんえんしています。 He's stopped smoking now.  25704
酔っ払い Noun 彼はただの酔っ払いです。	drunk person 彼かれはただの酔よっ払ぱらいです。 He's nothing but a drunk.  18185
ナイロン Noun このジャケットはナイロンでできています。	nylon このジャケットはナイロンでできています。 This jacket is made of nylon.  26108
酔っ払う Verb 昨夜は酔っ払いました。	get drunk 昨夜ゆうべは酔よっ払ぱらいました。 I got drunk last night.  14272
危ない Adjective その道は車が多くて危ない。	dangerous, uncertain その道みちは車くるまが多おおくて危あぶない。 There are many cars on that road, so it's dangerous.  3246
危険 Adjectival Noun その地域は今、危険だ。	danger, dangerous その地域ちいきは今いま、危険きけんだ。 That region is dangerous right now.  749
存在 Verbal Noun 宇宙人は存在すると思いますか。	existence, being 宇宙人うちゅうじんは存在そんざいすると思おもいますか。 Do you think that aliens exist?  401
スーツ Noun あのスーツはそんなに高くない。	suit あのスーツはそんなに高たかくない。 That suit is reasonably priced.  2779
注目 Verbal Noun 私たちはその会社に注目している。	attention, notice 私わたしたちはその会社かいしゃに注目ちゅうもくしている。 We have our eyes on that company.  3870
注文 Verbal Noun レストランでピザを注文しました。	order, request レストランでピザを注文ちゅうもんしました。 I ordered pizza at the restaurant.  2436
意味 Noun それはどういう意味ですか。	meaning, significance それはどういう意味いみですか。 What does that mean?  270
意見 Noun あなたの意見が聞きたいです。	opinion あなたの意見いけんが聞ききたいです。 I want to hear your opinion.  1128
チケット Noun この遊園地のチケットは3000円です。	ticket この遊園地ゆうえんちのチケットは3000円さんぜんえんです。 The tickets for this amusement park are 3000 yen.  12104
注意 Verbal Noun 車に注意してください。	attention, care, watch out 車くるまに注意ちゅういしてください。 Please watch out for traffic.  1111
用意 Verbal Noun 食事の用意ができました。	prepare, ready oneself 食事しょくじの用意よういができました。 The meal is ready.  972
確か Adjectival Noun 彼の昇進は確かだ。	for sure, for certain 彼かれの昇進しょうしんは確たしかだ。 He's sure to get a promotion.  1044
確認 Verbal Noun もう一度、予約を確認した。	confirmation もう一度いちど、予約よやくを確認かくにんした。 I confirmed my reservation one more time.  1067
チョコレート Noun 妹はチョコレートが大好きです。	chocolate 妹いもうとはチョコレートが大好だいすきです。 My little sister loves chocolate.  7838
機能 Verbal Noun このソフトにはいろいろな機能があります。	function, feature このソフトにはいろいろな機能きのうがあります。 This software has a lot of various features.  3024
ジェット機 Noun ジェット機が飛んでいる。	jet (plane) ジェット機きが飛とんでいる。 The jet plane is flying.  24907
機械 Noun 新しい機械が壊れた。	machine 新あたらしい機械きかいが壊こわれた。 The new machine broke.  1876
材料 Noun サラダの材料をそろえました。	ingredients, material サラダの材料ざいりょうをそろえました。 I have all the ingredients for the salad.  3487
チャンネル Noun テレビのチャンネルを変えてください。	channel テレビのチャンネルを変かえてください。 Please change the TV channel.  12830
具体的 Adjectival Noun 具体的な例をいくつか見せてください。	specific, concrete 具体的ぐたいてきな例れいをいくつか見みせてください。 Please show me some concrete examples.  3130
基づく Verb この話は真実に基づいています。	be based on この話はなしは真実しんじつに基もとづいています。 This story is based on truth.  8649
基本 Noun 今、ジャズダンスの基本を習っています。	basis, foundation 今いま、ジャズダンスの基本きほんを習ならっています。 We're learning the basics of jazz dance at the moment.  4597
基準 Noun 判断の基準が示された。	standard, criteria 判断はんだんの基準きじゅんが示しめされた。 The standards of judgment were outlined.  8750
つまらない Adjective 彼の話はつまらないですね。	boring, dull 彼かれの話はなしはつまらないですね。 What he's talking about is boring.  2913
備える Verb 災害に備えて大量の水を買い込んだ。	prepare for (disaster), equip (st) with 災害さいがいに備そなえて大量たいりょうの水みずを買かい込こんだ。 I bought large quantities of water to prepare for disasters.  3331
準備 Verbal Noun 明日の会議の準備をした。	prepare for, ready for 明日あすの会議かいぎの準備じゅんびをした。 I prepared for tomorrow's meeting.  1409
設計 Verbal Noun 兄は船の設計をしています。	design, plan 兄あには船ふねの設計せっけいをしています。 My big brother is designing a ship.  5842
施設 Noun そのホテルにはレジャー施設がたくさんある。	facilities, institution そのホテルにはレジャー施設しせつがたくさんある。 There are a lot of leisure facilities in the hotel.  4241
マッチ Noun マッチを持っていますか。	match, matchbox マッチを持もっていますか。 Do you have a match?  5926
設ける Verb 授業の終わりに復習の時間を設けた。	set up, establish, prepare 授業じゅぎょうの終おわりに復習ふくしゅうの時間じかんを設もうけた。 I set up a review time at the end of class.  4379
説明 Verbal Noun この単語の意味を説明してください。	explanation, description この単語たんごの意味いみを説明せつめいしてください。 Please tell me the meaning of this word.  512
小説 Noun 私は月に3冊くらい小説を読みます。	novel, story 私わたしは月つきに3冊さんさつくらい小説しょうせつを読よみます。 I read about three novels a month.  953
公開 Verbal Noun その映画は今日、公開されます。	opening (to the public) その映画えいがは今日きょう、公開こうかいされます。 The movie opens to the public today.  9352
いとこ Noun いとこと私は同じ年です。	cousin いとこと私わたしは同おなじ年としです。 My cousin and I are the same age.  9586
公園 Noun 子供たちが公園で遊んでいる。	park, public garden 子供こどもたちが公園こうえんで遊あそんでいる。 The children are playing in the park.  2049
動物園 Noun 昨日子供たちと動物園に行きました。	zoo 昨日子供きのう こどもたちと動物園どうぶつえんに行いきました。 I went to the zoo with my kids yesterday.  11561
祭り Noun 彼女は祭りが大好きです。	festival 彼女かのじょは祭まつりが大好だいすきです。 She loves festivals.  5023
国際 Noun ここで国際会議が開かれます。	international ここで国際こくさい会議かいぎが開ひらかれます。 An international conference is going to be held here.  5605
ストーブ Noun うちではまだストーブを使っています。	paraffin heater, stove うちではまだストーブを使つかっています。 We still use a heating stove at my house.  8425
実際 Adverb 彼は実際にはあまり背が高くない。	reality, truth, the actual situation 彼かれは実際じっさいにはあまり背せが高たかくない。 Actually, he's not very tall.  785
飛行場 Noun バスが飛行場に着きました。	airport, airfield バスが飛行場ひこうじょうに着つきました。 The bus arrived at the airport.  8743
航空便 Noun 航空便で書類が届きました。	airmail 航空便こうくうびんで書類しょるいが届とどきました。 The document reached me by airmail.  53169
船便 Noun アメリカの友人から船便が届いた。	surface mail (ship) アメリカの友人ゆうじんから船便ふなびんが届とどいた。 Something arrived by surface mail from my friend in the United States.  58274
ガソリンスタンド Noun この近くにガソリンスタンドはありますか。	gas station この近ちかくにガソリンスタンドはありますか。 Is there a gas station nearby?  32520
船 Noun 私たちは船に乗った。	ship, boat, vessel 私わたしたちは船ふねに乗のった。 We got on the ship.  486
空港 Noun 空港までリムジンバスで行った。	airport 空港くうこうまでリムジンバスで行いった。 I went to the airport by shuttle bus.  3536
港 Noun 港に船が着きました。	port, harbor 港みなとに船ふねが着つきました。 The ship arrived at the port.  2381
島 Noun 日本は島国です。	island, isle 日本にっぽんは島しま国ぐにです。 Japan is an island nation.  647
デート Verbal Noun デートで遊園地に行きました。	date デートで遊園地ゆうえんちに行いきました。 I went on a date to an amusement park.  4865
完成 Verbal Noun 新しいホームページが完成した。	completion, finish 新あたらしいホームページが完成かんせいした。 We finished our new home page.  2541
平成 Noun 彼女は平成3年生まれです。	Heisei era 彼女かのじょは平成へいせい3年生さんねんうまれです。 She was born in Heisei Year 3 (1991).  5643
成功 Verbal Noun ついに実験が成功した。	success ついに実験じっけんが成功せいこうした。 The experiment finally succeeded.  1347
原因 Noun この事故の原因は何ですか。	cause, origin この事故じこの原因げんいんは何なんですか。 What's the cause of the accident?  1393
ふすま Noun ふすまを閉めてください。	sliding door, fusuma ふすまを閉しめてください。 Please close the sliding door. 
資金 Noun 私たちは今、結婚資金を貯めています。	funds, a fund 私わたしたちは今いま、結婚けっこん資金しきんを貯ためています。 We're saving for the wedding now.  5918
投資 Verbal Noun 私は4つの会社に投資しています。	investment 私わたしは4よっつの会社かいしゃに投資とうししています。 I'm investing in four companies.  12673
願う Verb 彼が元気になるよう願っています。	wish, ask a favor, apply for 彼かれが元気げんきになるよう願ねがっています。 We're praying that he gets well.  1635
正確 Adjectival Noun 彼の計算は正確です。	accurate, precise 彼かれの計算けいさんは正確せいかくです。 His calculation is accurate.  1534
レモン Noun 紅茶にレモンを入れて飲んだ。	lemon 紅茶こうちゃにレモンを入いれて飲のんだ。 I put lemon in my tea and drank it.  9813
正しい Adjective それは正しい答えです。	correct, righteous, lawful それは正ただしい答こたえです。 That's the correct answer.  1212
正月 Noun お正月にはたいてい、家族が集まる。	New Year お正月しょうがつにはたいてい、家族かぞくが集あつまる。 Our family usually gets together for the new year.  3875
正直 Adjectival Noun 彼女はとても正直だ。	honest, upright 彼女かのじょはとても正直しょうじきだ。 She's very honest.  1492
異なる Verb 彼と私はいつも意見が異なる。	differ 彼かれと私わたしはいつも意見いけんが異ことなる。 He and I always have different opinions.  2699
チーズ Noun チーズを一切れ食べました。	cheese チーズを一切ひときれ食たべました。 I ate a slice of cheese.  9900
通常 Noun 通常は夜8時まで営業しています。	common, ordinary 通常つうじょうは夜8時よる はちじまで営業えいぎょうしています。 We're usually open until eight o'clock at night.  4544
非常に Adverb これは非常に重要です。	very, extremely これは非常ひじょうに重要じゅうようです。 This is very important.  1348
調べる Verb この単語の意味を辞書で調べましょう。	search (for), examine この単語たんごの意味いみを辞書じしょで調しらべましょう。 Let's look up the meaning of this word in the dictionary.  665
強調 Verbal Noun 彼は良いところだけを強調した。	emphasis, stress 彼かれは良よいところだけを強調きょうちょうした。 He only emphasized the strong points.  5629
ドライブ Verbal Noun 今日は群馬までドライブしました。	drive 今日きょうは群馬ぐんままでドライブしました。 I drove to Gunma today.  9406
季節 Noun 私の一番好きな季節は春です。	season 私わたしの一番好いちばん すきな季節きせつは春はるです。 My favorite season is spring.  3101
調査 Verbal Noun 私たちがその問題を調査しています。	investigation, examination 私わたしたちがその問題もんだいを調査ちょうさしています。 We're investigating that problem.  1721
提供 Verbal Noun 彼がパーティー会場を提供してくれました。	offer, provide 彼かれがパーティー会場かいじょうを提供ていきょうしてくれました。 He provided us with the venue for the party.  4393
提案 Verbal Noun そのアイデアは彼の提案です。	proposition, proposal そのアイデアは彼かれの提案ていあんです。 He's the one who proposed that idea.  3098
ラケット Noun テニスのラケットを買いました。	racket テニスのラケットを買かいました。 I bought a tennis racket.  32520
案内 Verbal Noun 私が中をご案内します。	guide, inform 私わたしが中なかをご案内あんないします。 I'll show you around inside.  1322
示す Verb 彼は新製品に興味を示している。	show, indicate 彼かれは新製品しんせいひんに興味きょうみを示しめしている。 He's showing interest in the new product.  660
連れて行く Verb 私も連れて行ってください。	take (a person) along 私わたしも連つれて行いってください。 Please take me along. 
連れて来る Verb 息子が友達を連れて来ました。	bring (a person) 息子むすこが友達ともだちを連つれて来きました。 My son brought a friend. 
スチュワーデス Noun 彼女はスチュワーデスになった。	flight attendant 彼女かのじょはスチュワーデスになった。 She's become a flight attendant.  17023
続ける Verb 仕事を続けてください。	continue (sth), keep up を 仕事しごとを続つづけてください。 Please continue working.  381
相手 Noun 試合の相手は誰ですか。	opponent, partner 試合しあいの相手あいては誰だれですか。 Who are they playing against?  212
会談 Verbal Noun 会談の内容が発表されました。	conference, talk 会談かいだんの内容ないようが発表はっぴょうされました。 The content of the talks was announced.  9412
相談 Verbal Noun 相談したいことがあります。	consultation, advice 相談そうだんしたいことがあります。 I'd like to get your advice on something.  1210
テープレコーダー Noun テープレコーダーで自分の声を録音しました。	tape recorder, cassette recorder テープレコーダーで自分じぶんの声こえを録音ろくおんしました。 I recorded my voice on the tape recorder.  24615
記者 Noun 彼は新聞記者です。	journalist, reporter 彼かれは新聞しんぶん記者きしゃです。 He's a newspaper journalist.  3073
記録 Verbal Noun マラソンで世界記録が出た。	record, documentation マラソンで世界せかい記録きろくが出でた。 There was a new world record in the marathon.  1791
録音 Verbal Noun そのラジオ番組はもう録音しました。	audio recording そのラジオ番組ばんぐみはもう録音ろくおんしました。 I've already recorded that radio show.  9032
登る Verb 私たちは昨年、富士山に登りました。	climb, mount, go up 私わたしたちは昨年さくねん、富士山ふじさんに登のぼりました。 We climbed Mount Fuji last year.  1526
ひげ Noun 父はひげをはやしています。	moustache, beard 父ちちはひげをはやしています。 My father's growing a beard. 
関する Verb その問題に関する記事を読みました。	concern, relate to その問題もんだいに関かんする記事きじを読よみました。 I read an article about the problem.  72261
関連 Verbal Noun 関連のセクションへ連絡した。	connection, relation 関連かんれんのセクションへ連絡れんらくした。 I contacted the related sections.  5186
関係 Verbal Noun 彼はその事件に関係がない。	relation, relationship 彼かれはその事件じけんに関係かんけいがない。 He has nothing to do with that incident.  366
状況 Noun この状況では出発は難しいです。	situation, conditions この状況じょうきょうでは出発しゅっぱつは難むずかしいです。 It will be difficult to depart in these conditions.  922
ぐっすり Adverb 赤ちゃんがぐっすり寝ている。	soundly (asleep) 赤あかちゃんがぐっすり寝ねている。 The baby's sleeping soundly.  8612
状態 Noun ここは道の状態がとても悪いです。	state, appearance (of a thing) ここは道みちの状態じょうたいがとても悪わるいです。 The road is in a very bad state here.  668
治る Verb けがはもう治りましたか。	get better, be cured けがはもう治なおりましたか。 Is your injury better yet?  5043
政治 Noun 私は政治に関心がある。	politics 私わたしは政治せいじに関心かんしんがある。 I'm interested in politics.  2044
治す Verb 早く風邪を治してください。	cure, heal 早はやく風邪かぜを治なおしてください。 I hope your cold gets better soon.  9611
ソース Noun ソースはどれですか。	sauce, Worcestershire sauce ソースはどれですか。 Which of these is Worcestershire sauce?  13525
政府 Noun そのデモについて政府は何もしなかった。	government, administration そのデモについて政府せいふは何なにもしなかった。 The government didn't do anything about the demonstration.  1855
党 Noun 党の代表が質問に答えました。	political party 党とうの代表だいひょうが質問しつもんに答こたえました。 The party spokesman answered the question.  3997
対策 Noun 一緒に対策を考えましょう。	measure, countermeasure 一緒いっしょに対策たいさくを考かんがえましょう。 Let's think together about what measures we'll take.  6606
政策 Noun 新しい政策はあまり良いとは思えません。	policy, political measures 新あたらしい政策せいさくはあまり良いいとは思おもえません。 I don't think the new policy is very good.  6699
タイプライター Noun 母は古いタイプライターを持っています。	typewriter 母ははは古ふるいタイプライターを持もっています。 My mother has an old typewriter.  21480
選ぶ Verb 良い家を選ぶのは難しい。	choose, elect 良よい家いえを選えらぶのは難むずかしい。 It's difficult to choose a good house.  872
選手 Noun 彼はプロのサッカー選手だ。	player (in a game); team member 彼かれはプロのサッカー選手せんしゅだ。 He's a professional soccer player.  2949
選挙 Verbal Noun 彼は選挙に出るつもりだ。	election 彼かれは選挙せんきょに出でるつもりだ。 He intends to run in the election.  7927
候補 Noun 会長の候補は3人います。	candidate, candidacy 会長かいちょうの候補こうほは3人さんにんいます。 There are three candidates for chairman.  9479
トマト Noun 私はトマトが大好きです。	tomato 私わたしはトマトが大好だいすきです。 I love tomatoes.  13359
首相 Noun 今の首相はあまり力がない。	prime minister 今いまの首相しゅしょうはあまり力ちからがない。 The current Prime Minister doesn't have much power.  4091
首都 Noun 東京は日本の首都です。	capital 東京とうきょうは日本にっぽんの首都しゅとです。 Tokyo is the capital of Japan.  5953
改革 Verbal Noun 彼は行政を改革したいと思っている。	reform 彼かれは行政ぎょうせいを改革かいかくしたいと思おもっている。 He wants to reform the administration.  9846
革 Noun 革のベルトを買いました。	leather 革かわのベルトを買かいました。 I bought a leather belt.  4874
バター Noun パンにバターをぬって食べました。	butter パンにバターをぬって食たべました。 I spread some butter on the bread and ate it.  9981
命令 Verbal Noun 彼女は命令に従わなかった。	command, order 彼女かのじょは命令めいれいに従したがわなかった。 She did not obey orders.  964
番組 Noun 私はこの番組が好きです。	program (TV, radio) 私わたしはこの番組ばんぐみが好すきです。 I like this show.  4771
組み立てる Verb 日曜日に本棚を組み立てます。	put together, assemble, construct 日曜日にちようびに本棚ほんだなを組くみ立たてます。 I'll assemble the bookshelf on Sunday.  12874
組織 Verbal Noun 彼はある組織のリーダーだ。	organization, structure, tissue 彼かれはある組織そしきのリーダーだ。 He's the leader of a certain organization.  1904
バレーボール Noun 妹はバレーボールが得意です。	volleyball 妹いもうとはバレーボールが得意とくいです。 My little sister is good at volleyball.  35660
進める Verb 早く授業を進めましょう。	advance, promote, speed (st) up 早はやく授業じゅぎょうを進すすめましょう。 Let's hurry up and proceed with our class.  1965
進む Verb 前に進んでください。	advance, move forward 前まえに進すすんでください。 Please move forward.  536
進学 Verbal Noun 彼女は来年、大学に進学する。	entering the next level of school 彼女かのじょは来年らいねん、大学だいがくに進学しんがくする。 She'll enter college next year.  12583
拡大 Verbal Noun この図を拡大コピーしてください。	magnification, enlargement この図ずを拡大かくだいコピーしてください。 Please make an enlargement of this chart.  5067
おかず Noun 晩ご飯のおかずは何?	side dish 晩ばんご飯はんのおかずは何?なに What are we having for dinner?  11459
責任 Noun 彼は失敗の責任を取って、会社を辞めた。	responsibility, liability 彼かれは失敗しっぱいの責任せきにんを取とって、会社かいしゃを辞やめた。 He took responsibility for the mistake and resigned from the company.  1494
辞める Verb 彼は会社を辞めます。	resign, retire 彼かれは会社かいしゃを辞やめます。 He's leaving the company.  3991
辞書 Noun 彼女は辞書をよく使います。	dictionary 彼女かのじょは辞書じしょをよく使つかいます。 She often uses the dictionary.  10858
通勤 Verbal Noun 毎朝、通勤に30分かかります。	commute 毎朝まいあさ、通勤つうきんに30分さんじゅっぷんかかります。 It takes thirty minutes to commute every morning.  17206
カレンダー Noun カレンダーに予定を書いた。	calendar カレンダーに予定よていを書かいた。 I wrote my schedule on the calendar.  16205
勤める Verb 私は銀行に勤めています。	to work for (~に) 私わたしは銀行ぎんこうに勤つとめています。 I'm working for a bank.  2675
事務所 Noun 後で事務所に来てください。	office, one's place of business 後あとで事務所じむしょに来きてください。 Please come to the office later.  1932
事務室 Noun 事務室でコピーを取って来ます。	office 事務室じむしつでコピーを取とって来きます。 I'm going to make copies in the office.  8950
従来 Noun このプリンターは従来のものより速い。	former, old このプリンターは従来じゅうらいのものより速はやい。 This printer prints faster than previous models.  7092
ハンドバッグ Noun ハンドバッグを忘れました。	handbag ハンドバッグを忘わすれました。 I forgot my handbag.  8142
成績 Noun 成績が上がりました。	grade (school), results, record 成績せいせきが上あがりました。 His grades went up.  4645
集める Verb 弟は切手を集めています。	collect, gather 弟おとうとは切手きってを集あつめています。 My little brother collects stamps.  1293
集まる Verb 駅前に人が集まっています。	gather, be collected 駅前えきまえに人ひとが集あつまっています。 Lots of people are gathered in front of the station.  1133
採用 Verbal Noun その会社は女性を多く採用している。	employment その会社かいしゃは女性じょせいを多おおく採用さいようしている。 This company employs many women.  5167
ベル Noun 玄関のベルが鳴った。	bell 玄関げんかんのベルが鳴なった。 The door bell rang.  1842
給料 Noun 来年から給料が上がります。	salary, pay 来年らいねんから給料きゅうりょうが上あがります。 I'm getting a pay raise as of next year.  5506
卒業 Verbal Noun 私は去年、大学を卒業した。	graduation 私わたしは去年きょねん、大学だいがくを卒業そつぎょうした。 I graduated from university last year.  2882
就職 Verbal Noun 最近、若い人たちの就職が難しくなっています。	finding employment 最近さいきん、若わかい人ひとたちの就職しゅうしょくが難むずかしくなっています。 It's been hard for young people to find jobs recently.  6877
退院 Verbal Noun 母が今日退院します。	discharge from a hospital 母ははが今日きょう退院たいいんします。 My mother is being discharged from the hospital today.  7979
インク Noun プリンターのインクを買った。	ink プリンターのインクを買かった。 I bought some printer ink.  11699
契約 Verbal Noun その選手は新しいチームと契約した。	contract, agreement その選手せんしゅは新あたらしいチームと契約けいやくした。 That player signed a contract with a new team.  3248
交渉 Verbal Noun 今、値段を交渉しています。	negotiation, bargaining 今いま、値段ねだんを交渉こうしょうしています。 We're currently negotiating the price.  2740
事件 Noun その事件の犯人はまだ捕まっていない。	event, incident, case その事件じけんの犯人はんにんはまだ捕つかまっていない。 The perpetrator of the incident hasn't been caught yet.  303
条件 Noun この条件では厳し過ぎます。	condition, terms この条件じょうけんでは厳きびし過すぎます。 It's too harsh under these conditions.  1788
クーラー Noun 暑いのでクーラーをつけました。	air conditioning, cooler 暑あついのでクーラーをつけました。 I turned on the air conditioning because it was hot.  17870
参加 Verbal Noun 明日は市民マラソンに参加します。	participation, taking part in 明日あすは市民しみんマラソンに参加さんかします。 I'll participate in the citizens' marathon tomorrow.  2275
増加 Verbal Noun 島の人口は年々増加しています。	increase, gain 島しまの人口じんこうは年々ねんねん増加ぞうかしています。 The population of the island increases every year.  11377
加える Verb 塩、コショウを加えてください。	add (one thing to another) (can be the same or a different kind of thing) 塩しお、コショウを加くわえてください。 Please add the salt and pepper.  1423
加工 Verbal Noun この工場では魚を加工している。	processing, manufacturing (turning st into st else) この工場こうじょうでは魚さかなを加工かこうしている。 This factory processes fish.  15673
ミルク Noun 赤ちゃんにミルクをあげた。	milk, baby milk 赤あかちゃんにミルクをあげた。 I fed the baby some milk.  7435
比べる Verb 今月と先月の売上を比べた。	compare, contrast 今月こんげつと先月せんげつの売上うりあげを比くらべた。 I compared this month's sales with last month's.  2143
批判 Verbal Noun 彼は同僚を批判した。	criticism, comment 彼かれは同僚どうりょうを批判ひはんした。 He criticized his colleague.  3533
評価 Verbal Noun 最近、彼の評価が上がった。	evaluation, rating 最近さいきん、彼かれの評価ひょうかが上あがった。 He's been receiving more recognition lately.  3283
対象 Noun このアンケートは大学生が対象です。	target, subject このアンケートは大学生だいがくせいが対象たいしょうです。 This questionnaire targets university students.  2721
サラダ Noun サラダをたくさん食べました。	salad サラダをたくさん食たべました。 I ate a lot of salad.  12194
故障 Verbal Noun 冷蔵庫が故障しました。	malfunction, fault, breakdown 冷蔵庫れいぞうこが故障こしょうしました。 The refrigerator broke down.  7629
修理 Verbal Noun 車を修理に出した。	repair, mending 車くるまを修理しゅうりに出だした。 I took the car in for repair.  5111
乗り換える Verb 次の駅で地下鉄に乗り換えます。	change, transfer (trainなど) 次つぎの駅えきで地下鉄ちかてつに乗のり換かえます。 I'm transfering to the subway at the next station.  14808
乗り換え Verbal Noun 次の駅で乗り換えです。	change (trainなど), transfer 次つぎの駅えきで乗のり換かえです。 I'm transfering at the next station.  36414
おじさん Noun 昨日おじさんに会いました。	uncle 昨日きのうおじさんに会あいました。 I met my uncle yesterday.  2206
換える Verb 車のタイヤを換えた。	swap, convert 車くるまのタイヤを換かえた。 I changed the tires on the car.  9334
着替える Verb 彼はきれいな服に着替えた。	change clothes 彼かれはきれいな服ふくに着替きがえた。 He changed into clean clothes.  4393
被る Verb 帽子を被って外出した。	put on (a hat) 帽子ぼうしを被かぶって外出がいしゅつした。 I went out wearing a hat.  5353
破る Verb 彼は約束を破った。	tear (st), break (through) （~を） 彼かれは約束やくそくを破やぶった。 He broke his promise.  1707
ベルト Noun ベルトがきつくなりました。	belt ベルトがきつくなりました。 My belt has gotten tight.  4496
破れる Verb シャツが破れている。	(st) rips, gets torn シャツが破やぶれている。 My shirt is ripped.  4548
壊す Verb 彼女が私のケータイを壊した。	break, destroy, smash 彼女かのじょが私わたしのケータイを壊こわした。 She destroyed my cell phone.  4099
壊れる Verb 会社のパソコンが壊れた。	break, break down, get out of order 会社かいしゃのパソコンが壊こわれた。 The company computer broke down.  3654
救急車 Noun 誰か救急車を呼んでください。	ambulance 誰だれか救急車きゅうきゅうしゃを呼よんでください。 Someone please call an ambulance.  6543
ラーメン Noun 夕食にラーメンを食べました。	ramen (Chinese noodles) 夕食ゆうしょくにラーメンを食たべました。 I ate ramen for supper.  10669
助ける Verb 彼女は病気の犬を助けた。	help, save 彼女かのじょは病気びょうきの犬いぬを助たすけた。 She helped a sick dog.  915
立派 Adjectival Noun 彼は立派な人です。	fine, excellent 彼かれは立派りっぱな人ひとです。 He's a fine man.  1253
警察 Noun 警察を呼んでください。	police 警察けいさつを呼よんでください。 Call the police.  587
管理 Verbal Noun 彼女が私のスケジュールを管理している。	management, administration 彼女かのじょが私わたしのスケジュールを管理かんりしている。 She manages my schedule.  4124
ライター Noun 店にライターを忘れました。	lighter 店みせにライターを忘わすれました。 I forgot my lighter at the shop.  5268
盗む Verb 誰かが私のカバンを盗みました。	steal, rob 誰だれかが私わたしのカバンを盗ぬすみました。 Someone stole my bag.  1933
殺す Verb 私は生き物を殺すのが嫌いだ。	kill, smother 私わたしは生いき物ものを殺ころすのが嫌きらいだ。 I hate killing living things.  214
逮捕 Verbal Noun 逃げていた犯人が逮捕されました。	arrest, capture 逃にげていた犯人はんにんが逮捕たいほされました。 They arrested that criminal who escaped.  2288
逃げる Verb 鳥が窓から逃げたよ。	escape, run away 鳥とりが窓まどから逃にげたよ。 The bird flew out of the window.  468
ワイシャツ Noun 彼は白いワイシャツを着ている。	(business) shirt, (white) shirt 彼かれは白しろいワイシャツを着きている。 He's wearing a white shirt.  9749
戦争 Verbal Noun 2003年にイラクで戦争があった。	war, battle 2003年にせんさんねんにイラクで戦争せんそうがあった。 There was a war in Iraq in 2003.  838
競争 Verbal Noun 2社は互いに競争している。	competition 2社にしゃは互たがいに競争きょうそうしている。 Two companies are competing with each other.  7732
混む Verb 電車が混んでいる。	be crowded, be congested 電車でんしゃが混こんでいる。 The train is crowded.  8421
大統領 Noun フランスの大統領は誰ですか。	president (of a country) フランスの大統領だいとうりょうは誰だれですか。 Who's the president of France?  4685
シャワー Noun 朝、急いでシャワーを浴びました。	shower 朝あさ、急いそいでシャワーを浴あびました。 I took a very quick shower in the morning.  4898
捨てる Verb ゴミを捨ててください。	throw away, abandon ゴミを捨すててください。 Please throw away the garbage.  780
拾う Verb 道で財布を拾った。	pick up, find 道みちで財布さいふを拾ひろった。 I picked up a wallet in the street.  1728
池 Noun 池に鯉がいます。	pond 池いけに鯉こいがいます。 There are carp in the pond.  1952
電池 Noun 新しい電池を入れましょう。	electric cell, battery 新あたらしい電池でんちを入いれましょう。 Let's put in a new battery.  19497
うどん Noun 私はお昼にうどんを食べました。	noodles, Japanese wheat noodles 私わたしはお昼ひるにうどんを食たべました。 I ate udon noodles for lunch.  11441
深い Adjective あの池はとても深い。	deep, profound, intimate あの池いけはとても深ふかい。 That pond is very deep.  374
深さ Noun このプールの深さは2メートルです。	depth, profundity このプールの深ふかさは2にメートルです。 This pool is two meters deep. 
浅い Adjective この川は浅いです。	shallow, superficial この川かわは浅あさいです。 This river is shallow.  3238
落とす Verb 途中で財布を落としました。	drop, omit 途中とちゅうで財布さいふを落おとしました。 I lost my purse on the way.  927
ごみ Noun 今日はごみの日だ。	rubbish, trash 今日きょうはごみの日ひだ。 Today is garbage day.  16217
泳ぐ Verb 彼女はダイエットのために泳いでいる。	swim 彼女かのじょはダイエットのために泳およいでいる。 She swims to lose weight.  3165
水泳 Verbal Noun 母は健康のために水泳をしている。	swimming 母ははは健康けんこうのために水泳すいえいをしている。 My mother swims for her health.  16480
流れる Verb ラジオから美しい音楽が流れています。	flow, drift away ラジオから美うつくしい音楽おんがくが流ながれています。 Beautiful music is coming from the radio.  635
流行る Verb 去年はスニーカーが流行りました。	be in fashion, be popular 去年きょねんはスニーカーが流行はやりました。 Sneakers were popular last year.  11033
スーパーマーケット Noun スーパーマーケットで人参を買った。	supermarket スーパーマーケットで人参にんじんを買かった。 I bought carrots at the supermarket.  24313
洗う Verb 早く顔を洗いなさい。	wash 早はやく顔かおを洗あらいなさい。 Hurry up and wash your face.  1618
洗面所 Noun 洗面所で顔を洗った。	washroom, bathroom 洗面所せんめんじょで顔かおを洗あらった。 She washed her face in the lavatory.  10626
油 Noun 水と油は混ざらない。	oil 水みずと油あぶらは混まざらない。 Oil and water don't mix.  3114
沈む Verb ボートが川に沈んだ。	sink, set ボートが川かわに沈しずんだ。 The boat sank in the river.  1429
ハンカチ Noun ハンカチで手をふきました。	handkerchief ハンカチで手てをふきました。 I wiped my hands with my handkerchief.  3554
久しぶり Adjectival Noun 明日、久しぶりに友達に会います。	after a long time 明日あした、久ひさしぶりに友達ともだちに会あいます。 Tomorrow I'm meeting a friend I haven't seen for a long time.  4446
氷 Noun グラスに氷を入れてください。	ice グラスに氷こおりを入いれてください。 Please put some ice in my glass.  2091
冷える Verb クーラーで体が冷えた。	get cold, get chilly クーラーで体からだが冷ひえた。 The air conditioner's given me the chills.  3895
冷やす Verb 頭を冷やしなさい。	cool (sth), chill (を) 頭あたまを冷ひやしなさい。 Cool your head.  9406
ビデオテープ Noun 私はビデオテープを30本持っています。	videotape 私わたしはビデオテープを30本持さんじゅっぽん もっています。 I have 30 videotapes.  22073
冷める Verb 彼への気持ちが冷めた。	cool down (from hot to room temp), subside 彼かれへの気持きもちが冷さめた。 My feelings for him have died down.  7423
凍る Verb 寒い朝は道路が凍ります。	freeze 寒さむい朝あさは道路どうろが凍こおります。 The roads freeze on cold mornings.  5582
冷蔵庫 Noun 飲み物は冷蔵庫にあります。	refrigerator 飲のみ物ものは冷蔵庫れいぞうこにあります。 Drinks are in the refrigerator.  4984
涼しい Adjective 夕方は涼しくなりますよ。	cool, refreshing 夕方ゆうがたは涼すずしくなりますよ。 It gets cooler in the evening.  6086
ぶらぶら Adverb 朝、近所をぶらぶらした。	wander aimlessly, hang about 朝あさ、近所きんじょをぶらぶらした。 I wandered around the neighborhood this morning.  5672
汚す Verb 彼は服を汚した。	make dirty, soil 彼かれは服ふくを汚よごした。 He got his clothes dirty.  6306
汚れ Noun 靴の汚れを落としました。	dirt, filth 靴くつの汚よごれを落おとしました。 I cleaned the dirt off the shoes.  7665
汚れる Verb エプロンをしないと服が汚れます。	become dirty, become defiled エプロンをしないと服ふくが汚よごれます。 Your clothes will get dirty if you don't wear an apron.  2827
景色 Noun ここは景色がきれいですね。	scene, landscape ここは景色けしきがきれいですね。 The scenery here is beautiful.  3646
アナウンサー Noun 私はアナウンサーになりたい。	news reader, announcer 私わたしはアナウンサーになりたい。 I want to become an announcer.  12295
影響 Verbal Noun 私は彼から大きな影響を受けました。	influence, effect 私わたしは彼かれから大おおきな影響えいきょうを受うけました。 I was deeply influenced by him.  1924
光る Verb 波がきらきら光っていました。	shine, emit light 波なみがきらきら光ひかっていました。 The waves sparkled brilliantly.  1097
太る Verb 私の姉はすぐ太ります。	grow fat, fatten 私わたしの姉あねはすぐ太ふとります。 My big sister puts on weight easily.  4036
太陽 Noun 太陽が雲に隠れた。	sun 太陽たいようが雲くもに隠かくれた。 The sun hid behind the clouds.  1400
スプーン Noun カレーライスはスプーンで食べます。	spoon カレーライスはスプーンで食たべます。 You eat curry and rice with a spoon.  8357
星 Noun 今夜は星がよく見えます。	star, planet, spot 今夜こんやは星ほしがよく見みえます。 You can see the stars clearly tonight.  983
地球 Noun 地球は丸い。	the Earth 地球ちきゅうは丸まるい。 The Earth is round.  1443
野球 Noun 友達と野球をしました。	baseball 友達ともだちと野球やきゅうをしました。 I played baseball with a friend.  3118
雲 Noun 今日は雲が多い。	cloud 今日きょうは雲くもが多おおい。 It's cloudy today.  1022
ブラウス Noun 彼女は白いブラウスを着ている。	blouse 彼女かのじょは白しろいブラウスを着きている。 She's wearing a white blouse.  8418
曇り Noun 今日は一日曇りでした。	cloudiness, cloudy weather 今日きょうは一日いちにち曇くもりでした。 It was cloudy all day today.  20113
地震 Noun 日本は地震が多いです。	earthquake 日本にほんは地震じしんが多おおいです。 Earthquakes are frequent in Japan.  5960
震える Verb 彼は寒くて震えていました。	tremble, quiver, shake 彼かれは寒さむくて震ふるえていました。 He was cold and shivering.  1232
振る Verb 犬がしっぽを振っている。	wave, shake, swing 犬いぬがしっぽを振ふっている。 The dog is wagging its tail.  429
リボン Noun プレゼントにリボンを付けた。	ribbon プレゼントにリボンを付つけた。 I put a ribbon on the present.  6209
揺れる Verb 風で木が揺れています。	shake, sway, rock 風かぜで木きが揺ゆれています。 The trees are swaying in the wind.  1653
神社 Noun 京都には神社がたくさんある。	Shinto shrine 京都きょうとには神社じんじゃがたくさんある。 There are many Shinto shrines in Kyoto.  1989
秘密 Adjectival Noun これは秘密です。	secret, privacy これは秘密ひみつです。 This is a secret.  1041
厳しい Adjective 私の上司はとても厳しい。	strict, severe, intense 私わたしの上司じょうしはとても厳きびしい。 My boss is very strict.  2177
いかが Adverb お加減はいかがですか。	how, what (polite) お加減かげんはいかがですか。 How are you feeling?  3176
年寄り Noun あの村にはお年寄りがたくさん住んでいます。	old person, a senior あの村むらにはお年寄としよりがたくさん住すんでいます。 A lot of elderly people live in that village.  4465
歴史 Noun 私は歴史に興味があります。	history 私わたしは歴史れきしに興味きょうみがあります。 I'm interested in history.  1323
世紀 Noun 新しい世紀の始まりです。	century 新あたらしい世紀せいきの始はじまりです。 It's the start of a new century.  2218
建設 Verbal Noun 新しいビルの建設が始まった。	construction, establishment 新あたらしいビルの建設けんせつが始はじまった。 Construction began on the new building.  3801
ステレオ Noun 彼はステレオで音楽を聞いた。	stereo 彼かれはステレオで音楽おんがくを聞きいた。 He's listening to music on the stereo.  19205
建物 Noun これは日本一古い建物です。	building, structure これは日本一古にほんいち ふるい建物たてものです。 This is the oldest building in Japan.  1040
建つ Verb ここに来年、家が建ちます。	be built, be erected ここに来年らいねん、家いえが建たちます。 Our house will be built here next year.  4363
構成 Verbal Noun システムの構成を変えてみました。	organization, makeup システムの構成こうせいを変かえてみました。 I've tried to reorganize the system.  3967
構造 Noun この建物の構造は複雑です。	structure, the construction この建物たてものの構造こうぞうは複雑ふくざつです。 The structure of this building is complex.  3441
フォーク Noun フォークをもらえますか。	fork フォークをもらえますか。 May I have a fork?  8317
橋 Noun あの橋は日本で一番長い。	bridge あの橋はしは日本にほんで一番長いちばん ながい。 That bridge is the longest in Japan.  1201
柱 Noun この家の柱は太い。	pillar, column この家いえの柱はしらは太ふとい。 The pillars in this house are thick.  1975
位置 Verbal Noun 私の町は東京の北に位置します。	position, location 私わたしの町まちは東京とうきょうの北きたに位置いちします。 My town is located north of Tokyo.  1166
離婚 Verbal Noun 友人が離婚しました。	divorce 友人ゆうじんが離婚りこんしました。 My friend got divorced.  3577
おば Noun おばは大阪に住んでいます。	aunt おばは大阪おおさかに住すんでいます。 My aunt lives in Osaka.  8631
停車 Verbal Noun この電車は東京まで停車致しません。	a stop (train), stopping この電車でんしゃは東京とうきょうまで停車ていしゃ致いたしません。 This train won't stop until Tokyo.  8452
バス停 Noun 次のバス停で降ります。	bus stop 次つぎのバス停ていで降おります。 I get off at the next bus stop.  15461
周辺 Noun この周辺には大学が多い。	surrounding area, outskirts この周辺しゅうへんには大学だいがくが多おおい。 There are a lot of universities in this area.  2889
隣 Noun 隣の家には犬がいます。	neighboring house, next seat 隣となりの家いえには犬いぬがいます。 They have a dog next door.  1039
きらきら Adverb 星がきらきら光っている。	shining, sparkling 星ほしがきらきら光ひかっている。 The stars are shining brightly.  6371
黄色 Noun 信号は黄色でした。	yellow 信号しんごうは黄色きいろでした。 The traffic light was yellow.  5118
横 Noun 横の長さは1メートルです。	side, width across 横よこの長ながさは1いちメートルです。 Its width is one meter.  462
横書き Noun この本は横書きです。	horizontal writing この本ほんは横書よこがきです。 This book is printed horizontally.  39517
判断 Verbal Noun 彼の判断は正しい。	judgment, decision 彼かれの判断はんだんは正ただしい。 His judgment is correct.  1146
どうぞ Adverb こちらへどうぞ。	please, by all means, here you are こちらへどうぞ。 This way please.  1153
断る Verb 私は彼のプロポーズを断った。	refuse, turn down 私わたしは彼かれのプロポーズを断ことわった。 I turned down his marriage proposal.  2368
横断歩道 Noun あそこに横断歩道があります。	crosswalk あそこに横断歩道おうだんほどうがあります。 There's a crosswalk over there.  22721
大幅 Adverb 計画を大幅に変更した。	drastically, substantially 計画けいかくを大幅おおはばに変更へんこうした。 We substantially changed the plan.  12210
訪れる Verb 私は夏に京都を訪れました。	visit, go to see 私わたしは夏なつに京都きょうとを訪おとずれました。 I visited Kyoto this summer.  1461
ネックレス Noun 妻にネックレスをプレゼントしました。	necklace 妻つまにネックレスをプレゼントしました。 I gave my wife a necklace.  14344
訪ねる Verb 彼はニューヨークの友達を訪ねた。	visit (place or person), drop in 彼かれはニューヨークの友達ともだちを訪たずねた。 He visited his friend in New York.  1401
冷房 Verbal Noun 冷房を入れてください。	air conditioning 冷房れいぼうを入いれてください。 Please turn on the air-conditioner.  19741
暖房 Verbal Noun 冬は暖房が必要です。	heating 冬ふゆは暖房だんぼうが必要ひつようです。 Heating is necessary in winter.  17381
文房具 Noun 新しい文房具を買いました。	stationery, writing materials 新あたらしい文房具ぶんぼうぐを買かいました。 I bought some new stationery.  31563
パジャマ Noun このパジャマを着て。	pajamas このパジャマを着きて。 Put on these pajamas.  7955
諸国 Noun 彼はヨーロッパ諸国を旅行した。	various countries 彼かれはヨーロッパ諸国しょこくを旅行りょこうした。 He traveled through various European countries.  6784
緑色 Noun 彼は緑色のジャケットを着ています。	green 彼かれは緑色みどりいろのジャケットを着きています。 He's wearing a green jacket.  3928
貿易 Verbal Noun 父は貿易の仕事をしています。	(foreign) trade, import/export business 父ちちは貿易ぼうえきの仕事しごとをしています。 My father works in the trading business.  8624
輸入 Verbal Noun これはイタリアから輸入した服です。	import これはイタリアから輸入ゆにゅうした服ふくです。 These clothes are imported from Italy.  8824
ボールペン Noun ボールペンで名前を書いてください。	ballpoint pen ボールペンで名前なまえを書かいてください。 Please write your name with a ballpoint pen.  13010
輸出 Verbal Noun 彼の会社は車を輸出しています。	export 彼かれの会社かいしゃは車くるまを輸出ゆしゅつしています。 His company exports cars.  12681
指輪 Noun 彼女に指輪をプレゼントしました。	ring 彼女かのじょに指輪ゆびわをプレゼントしました。 I gave her a ring as a gift.  3928
往復 Noun 往復切符をください。	round trip, going and returning 往復おうふく切符きっぷをください。 I'd like a roundtrip ticket please.  5955
復習 Verbal Noun 昨日の復習をしましたか。	review 昨日きのうの復習ふくしゅうをしましたか。 Did you review yesterday's lesson?  30022
すいか Noun 夏はすいかが美味しい。	watermelon 夏なつはすいかが美味おいしい。 Watermelon is delicious in summer.  73328
繰り返す Verb 彼女は同じ間違いを繰り返した。	repeat を 彼女かのじょは同おなじ間違まちがいを繰くり返かえした。 She repeated the same mistake.  1535
留学 Verbal Noun 1年間、アメリカに留学しました。	studying abroad 1年間いちねんかん、アメリカに留学りゅうがくしました。 I went to study in the United States for a year.  8365
停留所 Noun バスの停留所で10分待ちました。	stop, station バスの停留所ていりゅうじょで10分じゅっぷん待まちました。 I waited for ten minutes at the bus stop.  18743
書留 Noun これを書留で送りたいのですが。	registered mail これを書留かきとめで送おくりたいのですが。 I want to send this by registered mail.  54727
そちら Noun 夕方そちらに着きます。	there, that way (polite) 夕方ゆうがたそちらに着つきます。 I'll arrive there in the evening.  2271
守る Verb 彼は約束を守る人です。	protect, observe 彼かれは約束やくそくを守まもる人ひとです。 He's one to keep his promises.  726
留守 Noun 父は今、留守です。	not at home 父ちちは今いま、留守るすです。 My father isn't at home now.  3149
住宅 Noun ここは静かな住宅地だ。	housing, residence ここは静しずかな住宅じゅうたく地ちだ。 This is a quiet residential area.  7859
自宅 Noun 自宅に電話を下さい。	one's house, one's home 自宅じたくに電話でんわを下ください。 Please call home.  2420
そば Noun お昼にそばを食べた。	buckwheat noodles, soba お昼ひるにそばを食たべた。 I ate buckwheat noodles for lunch.  540
お宅 Noun 先生のお宅はどちらですか。	your home (敬語) 先生せんせいのお宅たくはどちらですか。 Where is the teacher's house?  16576
早起き Verbal Noun 祖父は早起きです。	early rising 祖父そふは早起はやおきです。 My grandfather gets up early.  15286
昼寝 Verbal Noun 私の子供は毎日昼寝をします。	nap 私わたしの子供こどもは毎日まいにち昼寝ひるねをします。 My child takes a nap every day.  10469
静か Adjectival Noun 今年の夏休みには静かな所へ行きたい。	quiet, tranquil 今年ことしの夏休なつやすみには静しずかな所ところへ行いきたい。 I want to go to a quiet place this summer vacation.  1048
どっち Noun どっちの色が好きですか。	which one (casual) どっちの色いろが好すきですか。 Which color do you like?  1968
暇 Noun 明日は暇ですか。	free time, spare time 明日あしたは暇ひまですか。 Are you free tomorrow?  1815
趣味 Noun 私の趣味は映画とテニスです。	hobby, interest 私わたしの趣味しゅみは映画えいがとテニスです。 My hobbies are tennis and movies.  2176
両方 Noun チョコレートとケーキを両方ください。	both チョコレートとケーキを両方りょうほうください。 I'll have both the chocolate and the cake, please.  3567
両替 Verbal Noun 1万円を両替してください。	exchanging currency, break (a 1万 note) 1万円いちまんえんを両替りょうがえしてください。 Please exchange 10,000 yen for me.  35894
バスケットボール Noun 姉はバスケットボールの選手です。	basketball 姉あねはバスケットボールの選手せんしゅです。 My big sister's a basketball player.  44363
両親 Noun 私の両親は大阪に住んでいます。	parents 私わたしの両親りょうしんは大阪おおさかに住すんでいます。 My parents live in Osaka.  1604
片道 Noun 東京まで片道切符を買った。	one-way 東京とうきょうまで片道かたみち切符きっぷを買かった。 I bought a one-way ticket to Tokyo.  29912
内側 Noun 白線の内側に下がってください。	inside, interior 白線はくせんの内側うちがわに下さがってください。 Please step back behind the white line.  2407
向こう側 Noun 私の家は川の向こう側にあります。	other side 私わたしの家いえは川かわの向むこう側がわにあります。 My house is on the other side of the river.  5595
サンドイッチ Noun 今日のお昼はサンドイッチです。	sandwich 今日きょうのお昼ひるはサンドイッチです。 We're having sandwiches for lunch.  11553
外側 Noun 白線の外側を歩かないでください。	exterior, outside 白線はくせんの外側そとがわを歩あるかないでください。 Please don't walk outside the white line.  5479
左側 Noun 画面の左側を見てください。	left side 画面がめんの左側ひだりがわを見みてください。 Please look at the left side of the screen.  5067
右側 Noun 彼女はいつも私の右側を歩きます。	right side 彼女かのじょはいつも私わたしの右側みぎがわを歩あるきます。 She always walks on my right.  4819
裏 Noun 会社の裏に公園があります。	rear, reverse (side), inside 会社かいしゃの裏うらに公園こうえんがあります。 There's a park behind the company.  1157
にこにこ Adverb 彼女はいつもにこにこしています。	smile 彼女かのじょはいつもにこにこしています。 She's always smiling.  5970
裏返す Verb 彼は紙を裏返しました。	turn over, turn inside out 彼かれは紙かみを裏返うらがえしました。 He turned the paper over.  15664
週刊誌 Noun その週刊誌はゴシップばかりだ。	weekly magazine その週刊誌しゅうかんしはゴシップばかりだ。 That weekly is full of gossip.  5458
朝刊 Noun 今日の朝刊に面白い記事があった。	morning edition 今日きょうの朝刊ちょうかんに面白おもしろい記事きじがあった。 There was an amusing article in today's morning paper.  12785
夕刊 Noun そのニュースは夕刊で見ました。	evening edition そのニュースは夕刊ゆうかんで見みました。 I saw that news in the evening newspaper.  9729
ウール Noun このウールのセーターは暖かい。	wool このウールのセーターは暖あたたかい。 This wool sweater is warm.  31927
詳しい Adjective もっと詳しく説明してください。	detailed, complete もっと詳くわしく説明せつめいしてください。 Please explain in greater detail.  3290
細かい Adjective 彼女は細かいことにうるさい。	minute, elaborate 彼女かのじょは細こまかいことにうるさい。 She's fussy about small details.  4234
細か Adjectival Noun それは細かな問題です。	minute, elaborate それは細こまかな問題もんだいです。 That's a complex issue.  10146
積もる Verb 雪が積もっています。	accumulate (snow, dustなど) 雪ゆきが積つもっています。 The snow has settled.  11312
コーラ Noun 私の兄はコーラが好きだ。	cola, coke 私わたしの兄あにはコーラが好すきだ。 My older brother likes cola.  10705
訳 Noun その文の訳を読みました。	translation その文ぶんの訳やくを読よみました。 I read a translation of that sentence.  1350
訳す Verb この文を訳してください。	translate この文ぶんを訳やくしてください。 Please translate this sentence.  9183
検討 Verbal Noun 今日中にこの問題を検討してください。	consideration, examination 今日中きょう じゅうにこの問題もんだいを検討けんとうしてください。 Please consider this problem by the end of the day.  5022
塗る Verb 壁にペンキを塗っています。	spread on, paint 壁かべにペンキを塗ぬっています。 I'm painting the wall.  2933
トイレットペーパー Noun トイレットペーパーを交換しました。	toilet paper トイレットペーパーを交換こうかんしました。 I changed the toilet paper.  40199
付く Verb 靴に泥が付いています。	stick to, be attached to, accompany 靴くつに泥どろが付ついています。 I have mud on my shoes.  1834
付ける Verb おまけを付けました。	attach, apply (st to st), add おまけを付つけました。 I added a freebie.  2488
受け付ける Verb 郵便物は5時まで受け付けています。	accept, receive 郵便物ゆうびんぶつは5時ごじまで受うけ付つけています。 We accept mail until five o'clock.  28372
片付ける Verb 早く部屋を片付けなさい。	put in order, clear (st) away, put (st) back 早はやく部屋へやを片付かたづけなさい。 Hurry up and clean up your room.  6216
どなた Noun 失礼ですが、どなたですか。	who (polite) 失礼しつれいですが、どなたですか。 Excuse me, but who are you?  4953
受付 Noun 受付は9時からです。	receptionist, front desk 受付うけつけは9時くじからです。 Registration is from nine o'clock.  5864
近付く Verb 女性が近付いてきました。	approach, get acquainted 女性じょせいが近付ちかづいてきました。 A woman approached me.  6335
片付く Verb 仕事が大分片付いた。	be in order, be settled 仕事しごとが大分だいぶ片付かたづいた。 I've completed a lot of my work.  17312
気を付ける Verb 体に気を付けてください。	take care of, pay attention to 体からだに気きを付つけてください。 Please take care of yourself. 
ハイキング Verbal Noun 昨日は友人とハイキングに行きました。	hiking 昨日きのうは友人ゆうじんとハイキングに行いきました。 I went hiking with a friend yesterday.  34408
貼る Verb 机にシールを貼った。	stick, paste 机つくえにシールを貼はった。 I stuck a sticker on the desk.  2781
記念日 Noun 今日は両親の結婚記念日です。	memorial day, anniversary 今日きょうは両親りょうしんの結婚けっこん記念日きねんびです。 Today's my parents' wedding anniversary.  24988
残念 Adjectival Noun その試合は残念な結果になった。	regretful, disappointing その試合しあいは残念ざんねんな結果けっかになった。 The result of the game was disappointing.  1447
例えば Adverb 例えば、このソフトで日本語を勉強することができます。	for example 例たとえば、このソフトで日本語にほんごを勉強べんきょうすることができます。 You can use this software to study Japanese, for example.  3444
ハム Noun ハムサンドをください。	ham ハムサンドをください。 Could I have a ham sandwich, please.  11761
例文 Noun 例文を3つ作ってください。	example sentence 例文れいぶんを3みっつ作つくってください。 Please make three example sentences.  63509
例 Noun 一つ例をあげてください。	example, precedent 一ひとつ例れいをあげてください。 Please give an example.  599
余る Verb 夕食の料理がたくさん余った。	remain over, be too much (remain because of excess) 夕食ゆうしょくの料理りょうりがたくさん余あまった。 A lot of food from dinner was left over.  7039
除く Verb 部長を除く全員が土曜日も働いた。	exclude, get rid of 部長ぶちょうを除のぞく全員ぜんいんが土曜日どようびも働はたらいた。 Everyone except the director worked on Saturday.  3394
ボーイフレンド Noun 私のボーイフレンドはハンサムな方でした。	boyfriend 私わたしのボーイフレンドはハンサムな方かたでした。 My boyfriend was a handsome man.  17641
削る Verb 彼は家族のために仕事の時間を削った。	grind down, trim, scale back 彼かれは家族かぞくのために仕事しごとの時間じかんを削けずった。 He reduced his working hours for his family's sake.  5297
遅刻 Verbal Noun 遅刻しないでください。	tardiness, lateness 遅刻ちこくしないでください。 Please don't be late.  9214
緩い Adjective このズボンは緩いです。	slack, loose このズボンは緩ゆるいです。 These trousers are loose.  18468
苦しい Adjective 食べ過ぎておなかが苦しい。	painful, difficult 食たべ過すぎておなかが苦くるしい。 I have eaten too much and my stomach hurts.  1473
アイロン Noun 彼女はシャツにアイロンをかけた。	iron 彼女かのじょはシャツにアイロンをかけた。 She ironed the shirt.  20172
苦い Adjective 私は苦いコーヒーが好きです。	bitter, sour 私わたしは苦にがいコーヒーが好すきです。 I like bitter coffee.  4985
苦手 Adjectival Noun 私は料理が苦手です。	weak point, (sb) hard to deal with 私わたしは料理りょうりが苦手にがてです。 I'm not good at cooking.  4436
困る Verb ケータイをなくして困っています。	be in trouble, have difficulty ケータイをなくして困こまっています。 I'm in a jam because I lost my cell phone.  567
貧乏 Adjectival Noun 彼は昔は貧乏だった。	poor, poverty 彼かれは昔むかしは貧乏びんぼうだった。 He used to be poor.  4081
カレーライス Noun 子供はカレーライスが好きです。	curry rice 子供こどもはカレーライスが好すきです。 Children like curry and rice.  26983
不幸 Adjectival Noun 彼女の家族に不幸があった。	unhappiness, misfortune, a death 彼女かのじょの家族かぞくに不幸ふこうがあった。 A misfortune befell her family.  1464
幸せ Adjectival Noun 良い友達がいて私は幸せだ。	happiness, good fortune 良いい友達ともだちがいて私わたしは幸しあわせだ。 I'm happy to have good friends.  1869
塩 Noun もうちょっと塩を入れて。	salt もうちょっと塩しおを入いれて。 Put in a little more salt.  3972
塩辛い Adjective 海の水は塩辛い。	salty 海うみの水みずは塩辛しおからい。 Sea water is salty.  42616
キャッシュカード Noun キャッシュカードでお金を下ろした。	ATM card キャッシュカードでお金かねを下おろした。 I took out some money with my ATM card.  38927
砂糖 Noun コーヒーに砂糖は入れますか。	sugar コーヒーに砂糖さとうは入いれますか。 Do you take sugar in your coffee?  6254
規模 Noun この動物園は日本一の規模です。	scale (big, smallなど), scope この動物園どうぶつえんは日本一にっぽんいちの規模きぼです。 This is the largest zoo in Japan.  5974
農業 Noun 私は農業を勉強しています。	agriculture 私わたしは農業のうぎょうを勉強べんきょうしています。 I'm studying agriculture.  9770
濃い Adjective 私は濃い味が好きだ。	thick, concentrated, dark-colored 私わたしは濃こい味あじが好すきだ。 I like strong tastes.  1884
イヤリング Noun 彼女はすてきなイヤリングをしている。	earrings 彼女かのじょはすてきなイヤリングをしている。 She's wearing wonderful earrings.  25154
薄い Adjective この電子辞書はとても薄い。	thin, weak, pale この電子辞書でんし じしょはとても薄うすい。 This electronic dictionary is very thin.  1457
厚い Adjective その辞書はとても厚い。	thick, bulky その辞書じしょはとても厚あつい。 That dictionary is very thick.  2309
厚さ Noun 私は板の厚さを測った。	thickness 私わたしは板いたの厚あつさを測はかった。 I measured the thickness of the board. 
迫る Verb 締め切りが迫っています。	approach, draw near, press (sb for st) 締しめ切きりが迫せまっています。 The deadline is approaching.  1370
ガールフレンド Noun 昔は彼女のことをガールフレンドと言っていました。	girlfriend 昔むかしは彼女かのじょのことをガールフレンドと言いっていました。 We used to call girlfriends garufurendo.  23427
伸びる Verb 髪がだいぶ伸びたね。	get longer, grow, stretch 髪かみがだいぶ伸のびたね。 Your hair has grown a lot, hasn't it?  2017
引っ越す Verb 来月、大阪に引っ越します。	move (houses) 来月らいげつ、大阪おおさかに引ひっ越こします。 I'll move to Osaka next month.  8111
越える Verb 私たちは高い山を越えました。	go over, go across, go beyond 私わたしたちは高たかい山やまを越こえました。 We went over a tall mountain.  1500
引っ越し Verbal Noun 去年、引っ越ししました。	moving (houses) 去年きょねん、引ひっ越こししました。 I moved last year.  12254
カセットテープ Noun 昔はカセットテープを使っていました。	cassette tape 昔むかしはカセットテープを使つかっていました。 I used to use cassette tapes along time ago.  39314
追い越す Verb 大きなトラックが私たちを追い越した。	pass, outdo 大おおきなトラックが私わたしたちを追おい越こした。 A big truck overtook us.  15814
上昇 Verbal Noun 地球の気温は上昇している。	a rise, an increase 地球ちきゅうの気温きおんは上昇じょうしょうしている。 The temperature of the earth is rising.  5649
改札口 Noun 改札口で会いましょう。	ticket barrier 改札口かいさつぐちで会あいましょう。 Let's meet at the ticket gate.  13004
失礼 Verbal Noun ではそろそろ失礼します。	impoliteness, bad manners, I beg your parden/Goodbye ではそろそろ失礼しつれいします。 Well, it's about time for me to go.  1690
かゆい Adjective 背中がかゆいです。	itchy 背中せなかがかゆいです。 My back itches.  21544
お礼 Verbal Noun 彼女にお礼の手紙を書きました。	thanks, reward, return present 彼女かのじょにお礼れいの手紙てがみを書かきました。 I wrote her a thank you letter.  3127
謝る Verb 彼は直ぐに謝りました。	apologize 彼かれは直すぐに謝あやまりました。 He apologized at once.  3109
注射 Verbal Noun 彼は注射があまり好きではありません。	shot, injection 彼かれは注射ちゅうしゃがあまり好すきではありません。 He's not too fond of getting shots.  8100
程度 Noun この程度の怪我なら大丈夫です。	degree, extent この程度ていどの怪我けがなら大丈夫だいじょうぶです。 With an injury of this small extent, she's going to be fine.  1091
ぐらぐら Adverb 地震で家がぐらぐらと揺れた。	wobble 地震じしんで家いえがぐらぐらと揺ゆれた。 The house shook because of the earthquake.  16042
誘う Verb 彼女をデートに誘った。	invite, ask out 彼女かのじょをデートに誘さそった。 I asked her out on a date.  1608
導入 Verbal Noun 会社で新しいシステムを導入した。	introduction, bringing in 会社かいしゃで新あたらしいシステムを導入どうにゅうした。 A new system was introduced in the company.  12447
努力 Verbal Noun もっと努力しよう。	effort, endeavor もっと努力どりょくしよう。 Let's try harder.  1551
怒る Verb 彼女が嘘をついたので、彼は怒った。	get angry, scold 彼女かのじょが嘘うそをついたので、彼かれは怒おこった。 He was angry because she lied to him.  791
ジャム Noun このイチゴでジャムを作りましょう。	jam このイチゴでジャムを作つくりましょう。 Let's make jam from these strawberries.  12763
独身 Noun 私の兄はまだ独身です。	single, unmarried 私わたしの兄あにはまだ独身どくしんです。 My big brother's still single.  5347
占める Verb 私に届くメールのうち、迷惑メールが7割を占めている。	occupy, hold 私わたしに届とどくメールのうち、迷惑めいわくメールが7割ななわりを占しめている。 About 70 percent of emails sent to me are junk.  3900
処理 Verbal Noun 事務的な処理に1週間かかります。	processing, management (unlike 加工, a new thing is not created) 事務的じむてきな処理しょりに1週間いっしゅうかんかかります。 The administrative processing takes one week.  3252
紹介 Verbal Noun 両親に彼女を紹介した。	introduction, presentation 両親りょうしんに彼女かのじょを紹介しょうかいした。 I introduced my girlfriend to my parents.  1488
スリッパ Noun スリッパをはいてください。	slippers スリッパをはいてください。 Wear slippers please.  10327
招く Verb 両親を食事に招いた。	invite, beckon 両親りょうしんを食事しょくじに招まねいた。 I invited my parents to a meal.  2462
招待 Verbal Noun 高校の時の先生を結婚式に招待した。	invitation 高校こうこうの時ときの先生せんせいを結婚式けっこんしきに招待しょうたいした。 I invited my high school teacher to the wedding.  4981
夫婦 Noun その夫婦はとても仲がいい。	husband and wife, married couple その夫婦ふうふはとても仲なかがいい。 That couple gets on very well.  1140
奥 Noun はさみは机の奥にあった。	inner part, the back, inner chamber はさみは机つくえの奥おくにあった。 The scissors were at the back of the desk.  515
トランプ Verbal Noun 友達とトランプをして遊びました。	(a pack of) cards, (playing) cards 友達ともだちとトランプをして遊あそびました。 I played cards with a friend.  10550
奥さん Noun 彼の奥さんはきれいな方です。	(sb's) wife, married lady 彼かれの奥おくさんはきれいな方かたです。 His wife is beautiful.  994
皆さん Noun 皆さんにお話があります。	everybody (丁寧語) 皆みなさんにお話はなしがあります。 I have something to say to everybody.  3415
皆様 Noun 皆様、こんにちは。	everyone (敬語) 皆様みなさま、こんにちは。 Hello everyone.  9950
誰か Noun 誰かに聞いてみてください。	someone 誰だれかに聞きいてみてください。 Please ask someone.  1419
よろしい Adjective レポートはこれでよろしいですか。	all right (いいの改まった言い方) レポートはこれでよろしいですか。 Is this all right as a report?  1141
国籍 Noun 私は日本国籍です。	citizenship, nationality 私わたしは日本にほん国籍こくせきです。 I'm a Japanese citizen.  16638
愛 Verbal Noun 彼女は愛をこめて手紙を書いた。	love 彼女かのじょは愛あいをこめて手紙てがみを書かいた。 She wrote a loving letter.  985
可愛い Adjective 彼女の赤ちゃんは可愛いです。	cute, charming, sweet 彼女かのじょの赤あかちゃんは可愛かわいいです。 Her baby is cute.  1824
恋人 Noun 彼は恋人を失った。	boyfriend/girlfriend, lover 彼かれは恋人こいびとを失うしなった。 He lost his girlfriend.  1521
ラッシュアワー Noun 私はラッシュアワーの電車が嫌いです。	rush hour 私わたしはラッシュアワーの電車でんしゃが嫌きらいです。 I hate rush hour trains.  53169
誕生日 Noun 彼女の誕生日は7月16日です。	birthday 彼女かのじょの誕生日たんじょうびは7月16日しちがつ じゅうろくにちです。 Her birthday is July 16th.  5554
祝日 Noun 5月3日は祝日だ。	holiday, festival day 5月3日ごがつ みっかは祝日しゅくじつだ。 May 3rd is a holiday.  32157
お祝い Verbal Noun 彼の就職のお祝いをしよう。	celebrate 彼かれの就職しゅうしょくのお祝いわいをしよう。 Let's celebrate his new employment.  9961
夢 Noun 昨夜恐ろしい夢を見た。	dream 昨夜ゆうべ恐おそろしい夢ゆめを見みた。 I had a terrible dream last night.  440
カップ Noun 水を1カップ入れてください。	cup, cup (measurement) 水みずを1いちカップ入いれてください。 Please put in one cup of water.  4279
泣く Verb 妹はすぐに泣く。	cry, weep 妹いもうとはすぐに泣なく。 My little sister cries easily.  544
涙 Noun 彼女の目から涙がこぼれた。	tear 彼女かのじょの目めから涙なみだがこぼれた。 Tears rolled down from her eyes.  641
喜ぶ Verb 彼女はとても喜びました。	be happy, be delighted 彼女かのじょはとても喜よろこびました。 She was very pleased.  1275
恥ずかしい Adjective とても恥ずかしかった。	embarrassed, ashamed, embarrassing とても恥はずかしかった。 It was very embarrassing.  1715
スケート Noun 湖でスケートをした。	skate, skates 湖みずうみでスケートをした。 We went skating on the lake.  33845
弁当 Noun 今日は弁当を持ってきました。	box lunch, picnic lunch 今日きょうは弁当べんとうを持もってきました。 I brought a lunch box today.  4787
看護師 Noun 母は看護師です。	nurse 母ははは看護師かんごしです。 My mother's a nurse.  22256
患者 Noun 患者は眠っています。	patient 患者かんじゃは眠ねむっています。 The patient is sleeping.  1854
述べる Verb 上司が意見を述べた。	express (opinion), state, mention 上司じょうしが意見いけんを述のべた。 Our boss gave us his opinion.  1329
たくさん Adverb 昨日はたくさん泳ぎました。	in large quantity, plenty 昨日きのうはたくさん泳およぎました。 I swam a lot yesterday.  896
訴える Verb 彼女は会社を訴えた。	sue 彼女かのじょは会社かいしゃを訴うったえた。 She sued the company.  2045
迷う Verb 道に迷いました。	hesitate, get lost, be unable to decide 道みちに迷まよいました。 I lost my way.  1660
迷惑 Verbal Noun 人に迷惑をかけてはいけません。	trouble, annoyance 人ひとに迷惑めいわくをかけてはいけません。 You shouldn't cause trouble for other people.  2260
地域 Noun この地域は雨が多い。	region, area この地域ちいきは雨あめが多おおい。 There's a lot of rain in this region.  3623
ピクニック Noun 今日はピクニックに行きましょう。	picnic 今日きょうはピクニックに行いきましょう。 Let's go on a picnic today.  21518
政権 Noun 政権が交代した。	political power, government, administration 政権せいけんが交代こうたいした。 There was a regime change.  7715
贈る Verb 母に花を贈った。	offer, give (presentとか) 母ははに花はなを贈おくった。 I sent my mother some flowers.  4288
贈り物 Noun すてきな贈り物をどうもありがとう。	present, gift (和語) すてきな贈おくり物ものをどうもありがとう。 Thank you for the wonderful present.  8249
与える Verb そのニュースは彼に大きなショックを与えた。	present (st), give (damage/shock), give (to lower status) (かたい) そのニュースは彼かれに大おおきなショックを与あたえた。 The news gave him a great shock.  524
あちら Noun あちらに行ってみよう。	way over there あちらに行いってみよう。 Let's go that way.  3248
貯金 Verbal Noun 貯金は十分にあります。	savings, deposit 貯金ちょきんは十分じゅうぶんにあります。 I have enough savings.  12026
預ける Verb 鍵を彼に預けた。	deposit, entrust 鍵かぎを彼かれに預あずけた。 I gave him the key to look after.  3462
預かる Verb 荷物を預かってください。	keep (st) for (sb); take care of (st) 荷物にもつを預あずかってください。 Please take care of the luggage.  6323
得意 Adjectival Noun 彼は歌が得意です。	one's forte, pride, frequent customer 彼かれは歌うたが得意とくいです。 He's good at singing.  2554
どきどき Adverb 彼女に会うとどきどきします。	feel excited, feel nervous 彼女かのじょに会あうとどきどきします。 I feel nervous when I meet her.  12681
燃える Verb 山が燃えています。	burn が 山やまが燃もえています。 The mountain's on fire.  1359
焼ける Verb 肉が焼けました。	burn, be grilled, be baked が 肉にくが焼やけました。 The meat is cooked.  2861
すき焼き Noun 昨日の夜はすき焼きを食べた。	sukiyaki 昨日きのうの夜よるはすき焼やきを食たべた。 I had sukiyaki last night.  47902
焼く Verb 今、魚を焼いています。	burn (st), grill, bake を 今いま、魚さかなを焼やいています。 I'm grilling fish now.  1518
まあまあ Adjective 彼の成績はまあまあです。	OK, not bad, average 彼かれの成績せいせきはまあまあです。 His results are so-so.  7410
乾く Verb 夏は洗濯物がすぐ乾く。	(st) drys, gets dry (が) 夏なつは洗濯物せんたくものがすぐ乾かわく。 Laundry dries quickly in summer.  2562
乾杯 Verbal Noun お二人の未来に乾杯しましょう。	a toast お二人ふたりの未来みらいに乾杯かんぱいしましょう。 Let's drink a toast to the couple's future.  8361
乾かす Verb ぬれた服を乾かした。	dry (st) を ぬれた服ふくを乾かわかした。 I dried the wet clothes.  17126
新幹線 Noun 新幹線で京都に行きました。	Shinkansen, Bullet Train 新幹線しんかんせんで京都きょうとに行いきました。 I went to Kyoto by bullet train.  8042
マフラー Noun 彼女は首にマフラーをまいていた。	scarf, muffler 彼女かのじょは首くびにマフラーをまいていた。 She was wearing a scarf around her neck.  13264
素晴らしい Adjective 素晴らしい景色ですね。	splendid, excellent 素晴すばらしい景色けしきですね。 This is wonderful scenery.  3879
海岸 Noun 海岸を散歩しましょう。	coast, seashore 海岸かいがんを散歩さんぽしましょう。 Let's take a walk along the coast.  3056
家庭 Noun 彼は家庭を大切にしている。	home, family 彼かれは家庭かていを大切たいせつにしている。 He values his family.  2040
庭 Noun 庭にバラを植えました。	garden, court 庭にわにバラを植うえました。 I planted a rose in the garden.  833
アクセサリー Noun このアクセサリーは素敵ね。	accessories, jewelry このアクセサリーは素敵すてきね。 This jewelry is lovely.  18443
桜 Noun 桜は三月か四月に咲きます。	cherry tree, cherry blossom 桜さくらは三月さんがつか四月しがつに咲さきます。 Cherry blossoms bloom in March or April.  968
咲く Verb 桜の花が咲きました。	bloom, blossom 桜さくらの花はなが咲さきました。 The cherry blossoms have bloomed.  3119
吹く Verb 今日は北風が吹いている。	blow, play on a wind instrument 今日きょうは北風きたかぜが吹ふいている。 The north wind is blowing today.  899
散歩 Verbal Noun 私のお祖父さんは毎日散歩します。	walk, stroll 私わたしのお祖父じいさんは毎日まいにち散歩さんぽします。 My grandfather takes a walk every day.  2670
あくび Verbal Noun 父があくびをした。	yawn 父ちちがあくびをした。 My father yawned.  9843
植える Verb 庭にバラを植えました。	plant (a plant), embed 庭にわにバラを植うえました。 I planted a rose in the garden.  5166
屋根 Noun 屋根にカラスが止まっています。	roof 屋根やねにカラスが止とまっています。 There's a crow on the roof.  1709
黒板 Noun 答えを黒板に書いてください。	blackboard 答こたえを黒板こくばんに書かいてください。 Please write the answer on the blackboard.  12513
掲示板 Noun 掲示板のお知らせを見ましたか。	notice board, bulletin board 掲示板けいじばんのお知しらせを見みましたか。 Did you see the notice on the bulletin board?  16599
からから Adjective おしゃべりして喉がからからになりました。	thirsty, dry おしゃべりして喉のどがからからになりました。 My throat got dry from chatting.  14439
草 Noun 庭に草が生えている。	grass, weed 庭にわに草くさが生はえている。 Weeds are growing in the garden.  1376
葉 Noun これは桜の葉です。	leaf これは桜さくらの葉はです。 This is a cherry tree leaf.  1248
絵葉書 Noun 友達から絵葉書が届きました。	picture postcard 友達ともだちから絵葉書えはがきが届とどきました。 I received a picture postcard from a friend.  25594
はがき Noun 家族にはがきを書いています。	postcard 家族かぞくにはがきを書かいています。 I'm writing a postcard to my family.  32555
ふらふら Adverb 私は疲れてふらふらです。	dizzy, weak 私わたしは疲つかれてふらふらです。 I'm tired and feel dizzy.  5805
吸う Verb 彼は大きく息を吸った。	inhale, suck 彼かれは大おおきく息いきを吸すった。 He took a deep breath.  1408
普及 Verbal Noun ゴミのリサイクルが普及している。	spreading, becoming popular ゴミのリサイクルが普及ふきゅうしている。 Garbage recycling has become widespread.  11966
胃 Noun 昨日から胃が痛い。	stomach 昨日きのうから胃いが痛いたい。 I've had a stomach ache since yesterday.  4557
皿 Noun 皿にケーキを載せました。	plate, counter for plates or servings 皿さらにケーキを載のせました。 I put the cake on the plate.  2200
こぼす Verb ソファにワインをこぼした。	spill (st) ソファにワインをこぼした。 I spilt wine on the sofa.  4035
血 Noun 血が出ていますよ。	blood 血ちが出でていますよ。 You're bleeding.  414
内容 Noun この本の内容を説明してください。	contents この本ほんの内容ないようを説明せつめいしてください。 Please explain the content of this book.  1288
背景 Noun 事件の背景に何があったのだろう。	background, scenery, setting 事件じけんの背景はいけいに何なにがあったのだろう。 I wonder what was behind the incident.  3784
骨 Noun 彼は足の骨を折りました。	bone, frame 彼かれは足あしの骨ほねを折おりました。 He broke a bone in his foot.  1346
ランチ Noun 一緒にランチに行きませんか。	lunch 一緒いっしょにランチに行いきませんか。 Do you want to go to lunch together?  9690
滑る Verb 彼は雪の上を滑った。	slide, slip, flunk an examination 彼かれは雪ゆきの上うえを滑すべった。 He slipped on the snow.  3524
折れる Verb 強風で木の枝が折れた。	snap/break, be folded, give in (to) 強風きょうふうで木きの枝えだが折おれた。 The tree branch broke in the strong wind.  2194
折る Verb 祖父は足の骨を折りました。	break off, fold, bend 祖父そふは足あしの骨ほねを折おりました。 My grandfather broke a bone in his foot.  2596
健康 Adjectival Noun 私は健康な生活を送っています。	healthy 私わたしは健康けんこうな生活せいかつを送おくっています。 I'm living a healthy lifestyle.  2798
レシート Noun レシートを財布に入れました。	receipt レシートを財布さいふに入いれました。 I put the receipt in my wallet.  37876
珍しい Adjective 昨日珍しい果物を食べました。	unusual, rare, strange 昨日きのう珍めずらしい果物くだものを食たべました。 I ate some unusual fruit yesterday.  1309
撮る Verb 写真をたくさん撮りました。	take (a picture), film (a video) 写真しゃしんをたくさん撮とりました。 I took a lot of photographs.  2607
再び Adverb 彼は再びここに戻ってきた。	again, a second time (somewhat formal) 彼かれは再ふたたびここに戻もどってきた。 He came back here once again.  742
再来年 Noun 次のオリンピックは再来年です。	the year after next 次つぎのオリンピックは再来年さらいねんです。 The next Olympics are the year after next.  60517
チョーク Noun チョークで黒板に字を書きました。	chalk チョークで黒板こくばんに字じを書かきました。 I wrote letters on the blackboard with chalk.  22554
再来月 Noun 再来月まで予約で一杯です。	the month after next 再来月さらいげつまで予約よやくで一杯いっぱいです。 They're fully booked until the month after the next.  98300
再来週 Noun 再来週は忙しいです。	the week after next 再来週さらいしゅうは忙いそがしいです。 I'll be busy the week after next.  74946
放送 Verbal Noun その番組は来週放送されます。	broadcasting その番組ばんぐみは来週らいしゅう放送ほうそうされます。 The program will be broadcast next week.  3870
装置 Noun 実験にはこの装置を使います。	equipment, device 実験じっけんにはこの装置そうちを使つかいます。 We use this device in our experiments.  2550
ティッシュ Noun ティッシュを取ってください。	tissue ティッシュを取とってください。 Please pass me the tissues.  17475
仮名 Noun お名前に仮名を振ってください。	kana, Japanese syllabary お名前なまえに仮名かなを振ふってください。 Please write the pronunciation of your name in kana.  13946
送り仮名 Noun その送り仮名は間違っています。	kana suffix その送おくり仮名がなは間違まちがっています。 That kana suffix is wrong.  117780
鏡 Noun 彼女は鏡を見て髪を直した。	mirror 彼女かのじょは鏡かがみを見みて髪かみを直なおした。 She looked in the mirror and tidied her hair.  1297
悲しむ Verb 父は友だちの死を悲しんでいます。	feel sad, lament 父ちちは友ともだちの死しを悲かなしんでいます。 My father is grieving because of his friend's death.  4819
ノック Verbal Noun 入る時はドアをノックしてください。	knock 入はいる時ときはドアをノックしてください。 Please knock before entering.  3683
固い Adjective 私の上司は頭が固い。	firm, unchanging, unbreakable 私わたしの上司じょうしは頭あたまが固かたい。 My boss is stubborn.  1735
美術館 Noun 昨日、美術館に行きました。	art museum 昨日きのう、美術館びじゅつかんに行いきました。 I went to the museum yesterday.  11305
美人 Noun 彼のお母さんは美人です。	beautiful woman 彼かれのお母かあさんは美人びじんです。 His mother's a beautiful woman.  2011
美容院 Noun 父は美容院で髪を切ります。	hair salon 父ちちは美容院びよういんで髪かみを切きります。 My father has his hair cut at a hair salon.  17641
よろしく Adverb よろしくお願いします。	properly, one's regards よろしくお願ねがいします。 My best regards.  2414
博物館 Noun 昨日、車の博物館に行った。	museum 昨日きのう、車くるまの博物館はくぶつかんに行いった。 I went to the car museum yesterday.  8524
開催 Verbal Noun 京都で国際会議が開催された。	holding (of an event), opening 京都きょうとで国際会議こくさいかいぎが開催かいさいされた。 An international conference was held in Kyoto.  11636
特徴 Noun この曲線がこの車の特徴です。	distinguishing characteristic この曲線きょくせんがこの車くるまの特徴とくちょうです。 These curves are a unique feature of this car.  2991
許す Verb 私は彼を許しました。	forgive, permit 私わたしは彼かれを許ゆるしました。 I forgave him.  745
がらがら Adjective 映画館はがらがらでした。	empty 映画館えいがかんはがらがらでした。 The movie theater was empty.  20976
免許証 Noun 免許証を見せてください。	license 免許証めんきょしょうを見みせてください。 Please show me your license.  24294
教師 Noun 彼は高校教師だ。	teacher, instructor 彼かれは高校こうこう教師きょうしだ。 He's a high school teacher.  2026
教授 Noun 彼は化学の教授です。	professor 彼かれは化学かがくの教授きょうじゅです。 He's a chemistry professor.  1585
伝える Verb みんなにこのことを伝えてください。	convey, tell (sb) that, let (sb) know みんなにこのことを伝つたえてください。 Please tell everyone about this matter.  873
ぎらぎら Adverb 太陽がぎらぎらしている。	dazzling, glaring, blinding 太陽たいようがぎらぎらしている。 The sun is glaring.  12897
鳥 Noun 鳥が飛んでいます。	bird, poultry 鳥とりが飛とんでいます。 A bird is flying.  1292
鳴る Verb 今朝、5時に電話が鳴った。	sound, ring, thunder 今朝けさ、5時ごじに電話でんわが鳴なった。 The telephone rang this morning at five o'clock.  971
鳴く Verb どこかでネコが鳴いている。	make sound (animal); chirp, meow, etc. どこかでネコが鳴ないている。 A cat is meowing somewhere.  3841
声 Noun 彼は大きな声で話した。	voice, sound 彼かれは大おおきな声こえで話はなした。 He spoke loudly.  86
そっち Noun そっちが私の部屋です。	there, that way (causal) そっちが私わたしの部屋へやです。 That's my room over there.  2240
卵 Noun ニワトリは卵を産みます。	egg ニワトリは卵たまごを産うみます。 Chickens lay eggs.  2940
犬 Noun この犬はとても賢い。	dog この犬いぬはとても賢かしこい。 This dog is very clever.  672
馬 Noun 彼は牧場で馬に乗った。	horse 彼かれは牧場ぼくじょうで馬うまに乗のった。 He rode a horse at the ranch.  387
駐車場 Noun 車は駐車場に止めてください。	parking area 車くるまは駐車場ちゅうしゃじょうに止とめてください。 Please park the car in the parking lot.  4351
ピンポン Verbal Noun 昨日の夕方、友達とピンポンをした。	table tennis, ping pong 昨日きのうの夕方ゆうがた、友達ともだちとピンポンをした。 I played ping-pong with a friend last night.  37293
騒ぐ Verb 電車の中で騒がないでください。	make a racket, mess around, make a fuss 電車でんしゃの中なかで騒さわがないでください。 Please don't make a racket in the train.  2738
刺す Verb 虫に腕を刺されました。	stab, prick, sting 虫むしに腕うでを刺さされました。 I was stung on the arm by an insect.  1981
刺身 Noun 私は刺身は食べません。	sashimi, sliced raw meat 私わたしは刺身さしみは食たべません。 I don't eat sashimi.  13010
激しい Adjective 激しい雨が降っています。	violent, intense 激はげしい雨あめが降ふっています。 A very heavy rain is falling.  855
ぺこぺこ Adjective 私はおなかがぺこぺこです。	very hungry, starving 私わたしはおなかがぺこぺこです。 I'm very hungry.  25484
驚く Verb 彼は血を見て驚いた。	be surprised, be startled 彼かれは血ちを見みて驚おどろいた。 He was surprised to see blood.  454
倒れる Verb 強風で木が倒れた。	fall down, succumb (to) 強風きょうふうで木きが倒たおれた。 The tree fell in the gale.  786
倒す Verb そのスキーヤーはポールを倒した。	knock down, overthrow, defeat そのスキーヤーはポールを倒たおした。 The skier knocked the pole down.  2071
傾向 Noun 最近の若者は難しい本を読まない傾向がある。	tendency, inclination 最近さいきんの若者わかものは難むずかしい本ほんを読よまない傾向けいこうがある。 Young people these days tend not to read difficult books.  4110
ぺらぺら Adjectival Noun 彼女はドイツ語がぺらぺらです。	fluently 彼女かのじょはドイツ語ごがぺらぺらです。 She speaks German fluently.  26860
柔道 Noun 私は柔道を習っています。	judo 私わたしは柔道じゅうどうを習ならっています。 I'm learning judo.  11464
柔らかい Adjective 布団がとても柔らかい。	soft 布団ふとんがとても柔やわらかい。 The futon is very soft.  3790
柔らか Adjectival Noun 彼の声は柔らかだ。	soft, tender, gentle 彼かれの声こえは柔やわらかだ。 His voice is gentle.  7625
主張 Verbal Noun 上司は私の主張を受け入れた。	argument, case, one's point 上司じょうしは私わたしの主張しゅちょうを受うけ入いれた。 My boss accepted my argument.  1887
レインコート Noun 雨なのでレインコートを着ました。	raincoat 雨あめなのでレインコートを着きました。 I put on my raincoat because it was raining.  16883
引っ張る Verb 娘が私の手を引っ張った。	pull, drag 娘むすめが私わたしの手てを引ひっ張ぱった。 My daughter tugged on my hand.  3023
突き当たる Verb 突き当たったら右に曲がってください。	come to the end of (street), run into (st) 突つき当あたったら右みぎに曲まがってください。 Please turn right when the street ends.  27996
突き当たり Noun この先は突き当たりです。	end of a street この先さきは突つき当あたりです。 There's a T-intersection ahead.  15681
壁 Noun 壁に絵が掛かっている。	wall, partition 壁かべに絵えが掛かかっている。 There's a painting on the wall.  467
アイス Noun 暑いのでアイスを食べました。	popsicle, ice lolly 暑あついのでアイスを食たべました。 I ate ice cream because it was hot.  17692
弾く Verb 彼はギターを弾きます。	play (a stringed instrument) 彼かれはギターを弾ひきます。 He plays the guitar.  2702
丸い Adjective 地球は丸い。	round 地球ちきゅうは丸まるい。 The earth is round.  1958
丸 Noun 紙に大きな丸を書きました。	circle, wholeness 紙かみに大おおきな丸まるを書かきました。 I drew a big circle on the paper.  1426
攻撃 Verbal Noun 2003年にアメリカはイラクを攻撃した。	attack, criticism 2003年にせんさんねんにアメリカはイラクを攻撃こうげきした。 The United States attacked Iraq in 2003.  1018
いつごろ Noun いつごろ夏休みを取りますか。	about when, about what time いつごろ夏休なつやすみを取とりますか。 About when are you going on summer vacation? 
絶対に Adverb 絶対に駄目です。	absolutely, unconditionally 絶対ぜったいに駄目だめです。 Absolutely not.  10851
消防車 Noun 消防車が4台も来た。	fire truck 消防車しょうぼうしゃが4台よんだいも来きた。 Four fire engines came.  26827
嫌 Adjectival Noun 私は待つのが嫌だ。	dislike, have a dislike for 私わたしは待まつのが嫌いやだ。 I hate waiting.  1215
大嫌い Adjectival Noun 私はテストが大嫌い。	hate 私わたしはテストが大嫌だいきらい。 I hate tests.  10474
ウィスキー Noun このウィスキーは強いよ。	whisky このウィスキーは強つよいよ。 This whisky is strong.  9567
大抵 Adverb 朝食は大抵7時頃に食べます。	generally, mostly 朝食ちょうしょくは大抵たいてい7時頃しちじごろに食たべます。 I usually eat breakfast around seven o'clock.  6667
大勢 Noun 大勢で食事に出かけました。	many (people), a crowd 大勢おおぜいで食事しょくじに出でかけました。 We went out to eat in a large group.  2109
姿 Noun 遠くに彼女の姿が見えた。	figure, appearance 遠とおくに彼女かのじょの姿すがたが見みえた。 I saw her figure from a long way away.  170
姿勢 Noun あの子はいつも姿勢が悪い。	posture, attitude あの子こはいつも姿勢しせいが悪わるい。 That kid always has bad posture.  1754
エアメール Noun 彼にエアメールを送りました。	airmail 彼かれにエアメールを送おくりました。 I sent him a letter by airmail.  90120
恐ろしい Adjective 昨夜恐ろしい夢を見た。	terrible, frightening 昨夜ゆうべ恐おそろしい夢ゆめを見みた。 I had a terrible dream last night.  845
怖い Adjective 私は犬が怖いです。	scary 私わたしは犬いぬが怖こわいです。 I'm scared of dogs.  995
糸 Noun 母は糸を針に通した。	thread, yarn 母ははは糸いとを針はりに通とおした。 My mother threaded the needle.  1867
孫 Noun 昨日、孫が生まれました。	grandchild 昨日きのう、孫まごが生うまれました。 My grandchild was born yesterday.  1741
シャープペンシル Noun 私のシャープペンシルがありません。	mechanical pencil 私わたしのシャープペンシルがありません。 My mechanical pencil is missing.  59483
木綿 Noun 彼女は木綿のシャツを着ています。	cotton 彼女かのじょは木綿もめんのシャツを着きています。 She's wearing a cotton shirt.  11397
偉い Adjective 彼は偉い学者です。	great, famous, eminent 彼かれは偉えらい学者がくしゃです。 He's a great scholar.  3907
爪 Noun 爪が伸びています。	nail, claw 爪つめが伸のびています。 My nails have grown.  2623
机 Noun 新しい机を買ってもらいました。	desk 新あたらしい机つくえを買かってもらいました。 They bought me a new desk.  1107
セロテープ Noun セロテープはありますか。	Scotch tape セロテープはありますか。 Do you have any scotch tape?  56799
棚 Noun 大きな棚はとても便利です。	shelf, rack 大おおきな棚たなはとても便利べんりです。 A large set of shelves is very useful.  2825
本棚 Noun これはとても大きな本棚ですね。	bookshelf これはとても大おおきな本棚ほんだなですね。 This is a very big bookcase.  8683
方針 Noun 今後の方針が決まった。	course, policy 今後こんごの方針ほうしんが決きまった。 We've decided our future policy.  4255
釣る Verb 昨日大きな魚を釣りました。	to fish, to catch (a fish) 昨日大きのう おおきな魚さかなを釣つりました。 I caught a big fish yesterday.  8289
やけど Verbal Noun 彼は手にやけどをしました。	burn 彼かれは手てにやけどをしました。 He burned his hand.  23826
お釣り Noun 母はお釣りを確かめた。	change 母はははお釣つりを確たしかめた。 My mother checked the change.  35598
鍵 Noun 出かける時は鍵を掛けてください。	key, lock 出でかける時ときは鍵かぎを掛かけてください。 Please lock the door when you go out.  1047
鍋 Noun 鍋にスープが入っているよ。	pan, pot 鍋なべにスープが入はいっているよ。 There's some soup in the pan.  3443
寿司 Noun 彼女は寿司を初めて食べました。	sushi 彼女かのじょは寿司すしを初はじめて食たべました。 She ate sushi for the first time.  14073
アイスコーヒー Noun アイスコーヒーをください。	iced coffee アイスコーヒーをください。 I'll have an iced coffee please.  31355
泥棒 Verbal Noun 近所に泥棒が入った。	thief, crook 近所きんじょに泥棒どろぼうが入はいった。 There was a burglary in the neighborhood.  3315
湯 Noun お風呂のお湯が一杯です。	hot water, hot bath, bathhouse お風呂ふろのお湯ゆが一杯いっぱいです。 The bath is filled with hot water.  2343
沸く Verb お風呂が沸きました。	boil, be excited お風呂ふろが沸わきました。 The bath is ready.  12094
沸かす Verb お湯を沸かしてください。	boil, excite お湯ゆを沸わかしてください。 Please boil the water.  16883
あっち Noun 郵便局はあっちです。	other side, over there (informal) 郵便局ゆうびんきょくはあっちです。 The post office is that way.  2937
洗濯機 Noun 新しい洗濯機を買いました。	washing machine 新あたらしい洗濯機せんたっきを買かいました。 I bought a new washing machine.  20445
洗濯 Verbal Noun 一週間、洗濯をしていない。	laundering, washing 一週間いっしゅうかん、洗濯せんたくをしていない。 I haven't done the laundry for a week.  6333
濡れる Verb 雨で濡れてしまった。	get wet 雨あめで濡ぬれてしまった。 I got wet in the rain.  2015
喫茶店 Noun 喫茶店でコーヒーを飲んだ。	coffee shop, tea house, café 喫茶店きっさてんでコーヒーを飲のんだ。 I drank coffee in the café  3169
あんなに Adverb あんなにいい人はいません。	like that あんなにいい人ひとはいません。 There could never be such a good person.  2252
怠ける Verb 怠けていないで、手伝って。	be lazy (が), neglect (st) (を) 怠なまけていないで、手伝てつだって。 Stop slacking and help me!  20056
一生懸命 Adverb 彼は毎日一生懸命働いている。	as hard as one can, with all one's might 彼かれは毎日まいにち一生懸命いっしょうけんめい働はたらいている。 He works hard every day.  4296
休憩 Verbal Noun 少し休憩しましょう。	break (from work, study, etc.) 少すこし休憩きゅうけいしましょう。 Let's take a break.  8667
天井 Noun この部屋は天井が高いですね。	ceiling この部屋へやは天井てんじょうが高たかいですね。 This room has a high ceiling.  1367
いたずら Verbal Noun その子はいたずらが大好きだ。	mischief, prank その子こはいたずらが大好だいすきだ。 That kid loves playing tricks.  4483
納豆 Noun 私は納豆をよく食べます。	natto (fermented soybeans) 私わたしは納豆なっとうをよく食たべます。 I often eat natto.  19439
化粧 Verbal Noun 彼女は化粧が上手い。	makeup, put on makeup 彼女かのじょは化粧けしょうが上手うまい。 She's very good with makeup.  3546
畑 Noun 母は畑仕事が好きだ。	field, farm, garden 母ははは畑はたけ仕事しごとが好すきだ。 My mother likes working in the field.  2427
炊く Verb 母は毎朝ご飯を炊く。	cook (by boiling) 母ははは毎朝まいあさご飯はんを炊たく。 My mother cooks rice every morning.  14367
ウェートレス Noun ウェートレスを呼んだ。	waitress ウェートレスを呼よんだ。 I called the waitress.  103602
自炊 Verbal Noun 私は毎日、自炊している。	cooking for oneself 私わたしは毎日まいにち、自炊じすいしている。 I cook for myself every day.  35407
灰皿 Noun 灰皿をください。	ashtray 灰皿はいざらをください。 Please give me an ashtray.  7006
灰 Noun 火事ですべて灰になった。	ashes 火事かじですべて灰はいになった。 Everything turned to ashes in the fire.  3775
灰色 Noun 今日の空は灰色だ。	ash color, gray 今日きょうの空そらは灰色はいいろだ。 The sky's gray today.  2116
おばさん Noun おばさん一家が遊びに来ました。	aunt おばさん一家いっかが遊あそびに来きました。 My aunt and her family came to visit.  2258
西暦 Noun 西暦1964年に東京でオリンピックがあった。	CE, AD (year) 西暦せいれき 1964年ねんに東京とうきょうでオリンピックがあった。 The Tokyo Olympics were held in 1964.  20916
毛 Noun 猫の毛がセーターに付いた。	hair, wool 猫ねこの毛けがセーターに付ついた。 I got cat hair on my sweater.  2197
髪 Noun 昨日、髪を切りました。	hair, hairstyle 昨日きのう、髪かみを切きりました。 I had my hair cut yesterday.  560
舌 Noun 舌を出してください。	tongue 舌したを出だしてください。 Stick out your tongue.  1412
くし Noun 彼はくしで髪をとかした。	comb 彼かれはくしで髪かみをとかした。 He combed his hair.  9755
臭い Adjective 納豆は臭い。	ill-smelling, stinking 納豆なっとうは臭くさい。 Natto stinks.  2095
匂い Noun いい匂いがする。	smell, odor いい匂においがする。 It smells good.  1101
居る Verb 今日は一日中家にいました。	be present 今日きょうは一日中家いちにちじゅう うちにいました。 I was at home all day today.  561
履く Verb 彼女はブーツを履いています。	put on (footwear, lower body clothing) 彼女かのじょはブーツを履はいています。 She's wearing boots.  5687
クリーニング Verbal Noun スーツをクリーニングに出しました。	cleaning, laundry スーツをクリーニングに出だしました。 I sent the suit to the cleaners.  29580
戸 Noun 部屋の戸が開いています。	door (esp. Japanese style), shutter 部屋へやの戸とが開あいています。 The room's door is open.  1452
扇風機 Noun 暑いから扇風機をつけよう。	electric fan 暑あついから扇風機せんぷうきをつけよう。 It's hot, so let's turn on the fan.  26163
豚 Noun 豚はすごく鼻が良い。	pig, pork 豚ぶたはすごく鼻はなが良いい。 Pigs have a very good sense of smell.  4629
豚肉 Noun 豚肉は美味しいです。	pork, hog meat 豚肉ぶたにくは美味おいしいです。 Pork is delicious.  22292
ごちそう Noun テーブルの上にごちそうが並んでいる。	feast, treat テーブルの上うえにごちそうが並ならんでいる。 There are some delicious treats lined up on the table.  10179
鶏 Noun その鶏は毎朝鳴きます。	chicken, hen その鶏にわとりは毎朝鳴まいあさ なきます。 The rooster crows every morning.  5293
腕時計 Noun 私の腕時計は遅れている。	wrist watch 私わたしの腕時計うでどけいは遅おくれている。 My watch is slow.  4434
お菓子 Noun みんなにお菓子をあげましょう。	sweets, snacks みんなにお菓子かしをあげましょう。 Let's give everyone some sweets.  8055
お辞儀 Verbal Noun 皆、社長にお辞儀をした。	bow, bowing 皆みんな、社長しゃちょうにお辞儀じぎをした。 Everyone bowed to the company president.  6324
ごちそうする Verb 今日の夕食は私がごちそうします。	treat 今日きょうの夕食ゆうしょくは私わたしがごちそうします。 I'll treat you to dinner tonight. 
寝坊 Verbal Noun 今朝は寝坊しました。	oversleeping, late riser 今朝けさは寝坊ねぼうしました。 I slept in this morning.  24565
旗 Noun 旗が風に揺れている。	flag, banner 旗はたが風かぜに揺ゆれている。 The flag is waving in the wind.  2915
鉛筆 Noun 鉛筆を貸して下さい。	pencil 鉛筆えんぴつを貸かして下ください。 Please lend me a pencil.  6948
万年筆 Noun 父に万年筆をプレゼントしました。	fountain pen 父ちちに万年筆まんねんひつをプレゼントしました。 I gave my father a fountain pen.  14100
こぼれる Verb 彼女の目から涙がこぼれた。	(st) spills, overflows 彼女かのじょの目めから涙なみだがこぼれた。 Tears rolled down from her eyes.  4279
箱 Noun この箱は重い。	box, case この箱はこは重おもい。 This box is heavy.  1162
本箱 Noun 雑誌を本箱に入れました。	bookcase 雑誌ざっしを本箱ほんばこに入いれました。 I put the magazine in the bookcase.  31509
手袋 Noun 寒いので手袋をしました。	gloves 寒さむいので手袋てぶくろをしました。 I wore gloves because it was cold.  4866
袋 Noun 袋はいりません。	bag, sack 袋ふくろはいりません。 I don't need a bag.  1832
こんなに Adverb こんなに面白い本は初めて読んだ。	as this, so, such こんなに面白おもしろい本ほんは初はじめて読よんだ。 I've never read such an interesting book before.  1240
財布 Noun 会社に財布を忘れた。	purse, wallet 会社かいしゃに財布さいふを忘わすれた。 I left my wallet at the office.  3757
毛布 Noun この毛布は暖かい。	blanket この毛布もうふは暖あたたかい。 This blanket is warm.  3860
布団 Noun 母が布団を干している。	futon, bedquilt 母ははが布団ふとんを干ほしている。 My mother is airing the futons.  2884
小包 Noun フランスの友達から小包が届いた。	parcel, package フランスの友達ともだちから小包こづつみが届とどいた。 A package arrived from a friend in France.  24241
ざあざあ Adverb 雨がざあざあ降っている。	(sound of pouring rain) heavily, pouring 雨あめがざあざあ降ふっている。 It's pouring.  57176
包む Verb プレゼントをきれいな紙で包みました。	wrap, pack プレゼントをきれいな紙かみで包つつみました。 I wrapped the present in beautiful paper.  1096
飾る Verb テーブルの上に花を飾りました。	decorate, exhibit テーブルの上うえに花はなを飾かざりました。 I decorated the table with flowers.  2726
手帳 Noun 新しい手帳を買いました。	pocketbook, memo 新あたらしい手帳てちょうを買かいました。 I bought a new notebook.  4921
電話帳 Noun 電話帳を見せてください。	telephone book 電話帳でんわちょうを見みせてください。 Please show me the telephone book.  19163
ジャガイモ Noun ポテトサラダを作るから、ジャガイモを買ってきて。	potato ポテトサラダを作つくるから、ジャガイモを買かってきて。 I'm going to make potato salad, so go and buy some potatoes.  20397
牛乳 Noun 私は毎朝、牛乳を飲む。	milk 私わたしは毎朝まいあさ、 牛乳ぎゅうにゅうを飲のむ。 I drink milk every morning.  7433
玄関 Noun 玄関に花を飾りました。	entrance, doorway 玄関げんかんに花はなを飾かざりました。 I decorated the entrance with flowers.  977
眼鏡 Noun 彼は眼鏡をかけています。	glasses, judgment 彼かれは眼鏡めがねをかけています。 He's wearing glasses.  2458
眠い Adjective 今日はとても眠いです。	sleepy 今日きょうはとても眠ねむいです。 I'm very sleepy today.  4792
ソファ Noun このソファは気持ちがいい。	sofa, sofa bed このソファは気持きもちがいい。 This sofa is very comfortable.  2351
眠る Verb 昨日は8時間眠りました。	sleep 昨日きのうは8時間はちじかん眠ねむりました。 I slept for eight hours yesterday.  758
封筒 Noun その手紙を封筒に入れた。	envelope その手紙てがみを封筒ふうとうに入いれた。 I put that letter in an envelope.  3619
出かける Verb 主人はもう出かけました。	go out, be about to go out 主人しゅじんはもう出でかけました。 My husband has already gone out.  807
かかる Verb 壁に大きな時計がかかっています。	hang, splash, take (timeなど) が 壁かべに大おおきな時計とけいがかかっています。 There's a big clock hanging on the wall.  222
煙草 Noun 彼は煙草を吸いません。	tobacco, cigarette 彼かれは 煙草たばこを吸すいません。 He doesn't smoke.  1317
掛け算 Verbal Noun 弟は掛け算を習っている。	multiplication 弟おとうとは掛かけ算ざんを習ならっている。 My little brother is learning his multiplication tables.  68263
拍手 Verbal Noun 大きな拍手が上がった。	applause, clapping 大おおきな拍手はくしゅが上あがった。 There was a big round of applause.  4477
掃除 Verbal Noun 週末は部屋の掃除をしました。	cleaning 週末しゅうまつは部屋へやの掃除そうじをしました。 I cleaned my room on the weekend.  2926
掃く Verb 床をほうきで掃きました。	sweep, brush 床ゆかをほうきで掃はきました。 I swept the floor with a broom.  11833
ちょうど Adverb 値段はちょうど3万円です。	exactly, as if 値段ねだんはちょうど3万円さんまんえんです。 The price is exactly 30,000 yen.  688
掃除機 Noun 掃除機が壊れた。	vacuum cleaner 掃除機そうじきが壊こわれた。 The vacuum cleaner broke.  29809
握る Verb 少女は母親の手を握った。	grasp, to press into shape (onigiri, sushi) 少女しょうじょは母親ははおやの手てを握にぎった。 The girl clasped her mother's hand.  868
握手 Verbal Noun 彼らは握手をした。	handshake, handshaking 彼かれらは握手あくしゅをした。 They shook hands.  5336
迎える Verb 姉が空港まで迎えに来てくれます。	welcome, go to meet 姉あねが空港くうこうまで迎むかえに来きてくれます。 My big sister is coming to pick me up at the airport.  920
ちょっと Adverb もうちょっと塩を入れて。	just a moment, just a little, easily もうちょっと塩しおを入いれて。 Put in a little more salt.  196
お巡りさん Noun あのお巡りさんに道を聞きましょう。	policeman あのお巡まわりさんに道みちを聞ききましょう。 Let's ask that policeman how to get there.  24009
いくつ Noun 娘さんはいくつになりましたか。	how many, how old 娘むすめさんはいくつになりましたか。 How old is your daughter now?  965
幾ら Noun この靴は幾らですか。	how much この靴くつは幾いくらですか。 How much are these shoes?  16541
冗談 Noun 冗談は止めてください。	joke 冗談じょうだんは止やめてください。 Please stop joking.  1217
つく Verb 部屋の電気がついています。	be on, switched on 部屋へやの電気でんきがついています。 The room light is on.  124
穴 Noun 靴下に穴が開いている。	hole, cavity 靴下くつしたに穴あなが開あいている。 There are holes in my socks.  906
寂しい Adjective これは寂しい曲ですね。	lonely, desolate, sad これは寂さびしい曲きょくですね。 This is a sad song.  2953
丁寧 Adjectival Noun 彼女はいつも丁寧に仕事をします。	polite, courteous, careful 彼女かのじょはいつも丁寧ていねいに仕事しごとをします。 She always works carefully.  3276
かわいそう Adjectival Noun そのかわいそうな子供たちは食べるものがない。	poor, pitiable そのかわいそうな子供こどもたちは食たべるものがない。 Those poor children have nothing to eat.  3142
てんぷら Noun 私はえびのてんぷらが好きです。	tempura, Japanese deep-fried breaded food 私わたしはえびのてんぷらが好すきです。 I like shrimp tempura.  42439
怪我 Verbal Noun 彼女は腕を怪我した。	injury 彼女かのじょは腕うでを怪我けがした。 She injured her arm.  2883
我慢 Verbal Noun 彼のわがままには我慢できません。	patience, self-restraint 彼かれのわがままには我慢がまんできません。 I can't put up with his selfishness.  1902
幼稚園 Noun 娘は幼稚園に通っています。	kindergarten 娘むすめは幼稚園ようちえんに通かよっています。 My daughter goes to kindergarten.  9630
隠れる Verb 太陽が雲に隠れた。	hide, disappear 太陽たいようが雲くもに隠かくれた。 The sun hid behind the clouds.  1739
とんとん Adverb 母の肩をとんとんたたいた。	tapping 母ははの肩かたをとんとんたたいた。 I patted my mother's shoulders as a massage.  21871
日陰 Noun 暑いので日陰で休みましょう。	the shade 暑あついので日陰ひかげで休やすみましょう。 It's hot so let's take a rest in the shade.  21596
随分 Adverb 随分[ずいぶん]早く終わったね。	extremely, considerably 随分ずいぶん早はやく終おわったね。 You finished really early, didn't you?  1062
頑張る Verb 明日の試験、頑張ってね。	persist, be tenacious 明日あしたの試験しけん、頑張がんばってね。 Good luck on tomorrow's exam.  2969
頃 Noun 子供の頃、よくその公園で遊んだ。	when~, about~, time 子供こどもの頃ころ、よくその公園こうえんで遊あそんだ。 I often played in that park when I was a kid.  466
人参 Noun 私は人参が嫌いだ。	carrot 私わたしは人参にんじんが嫌きらいだ。 I hate carrots.  20113
この頃 Noun この頃、よく肩が凝る。	these days, recently この頃ごろ、よく肩かたが凝こる。 These days I often get stiff shoulders.  3602
消防署 Noun この町には消防署が1つしかありません。	fire station この町まちには消防署しょうぼうしょが1ひとつしかありません。 There's only one fire station in this town.  34937
尋ねる Verb 彼女は道を尋ねた。	inquire, search for 彼女かのじょは道みちを尋たずねた。 She asked for directions.  863
缶詰 Noun 缶詰のフルーツはとても甘い。	canned goods 缶詰かんづめのフルーツはとても甘あまい。 Canned fruit is very sweet.  15043
ぬるい Adjective 風呂がぬるかった。	lukewarm 風呂ふろがぬるかった。 The bath was lukewarm.  18693
缶 Noun コーヒーはその缶に入っています。	can, tin コーヒーはその缶かんに入はいっています。 The coffee is in that can.  6560
腐る Verb リンゴが腐っている。	rot, corrode リンゴが腐くさっている。 This apple's rotten.  4116
豆腐 Noun 私は毎日豆腐を食べます。	tofu 私わたしは毎日まいにち豆腐とうふを食たべます。 I eat tofu every day.  9391
床 Noun 床が濡れている。	floor 床ゆかが濡ぬれている。 The floor is wet.  572
パーセント Noun この村の80パーセントは老人です。	percent この村むらの80はちじゅっパーセントは老人ろうじんです。 Eighty percent of the people in this village are elderly.  3297
床屋 Noun 昨日床屋で髪を切った。	barber, barbershop 昨日きのう床屋とこやで髪かみを切きった。 Yesterday I had my hair cut at the barber's.  11517
畳 Noun そのホテルには畳の部屋がある。	tatami, mat そのホテルには畳たたみの部屋へやがある。 That hotel has tatami rooms.  1637
畳む Verb 布団を畳んでください。	fold up, shut (umbrella) 布団ふとんを畳たたんでください。 Please fold up the futon.  10794
干す Verb 母は洗濯物を干しています。	dry (by airing out), air out 母ははは洗濯物せんたくものを干ほしています。 My mother's hanging out the laundry to dry.  8285
ひざ Noun スキーでひざを怪我しました。	knee スキーでひざを怪我けがしました。 I injured my knee skiing.  5371
帽子 Noun 暑いので帽子を被りましょう。	hat 暑あついので帽子ぼうしを被かぶりましょう。 You should wear a hat because it's hot.  1773
ぜひ Adverb ぜひ、うちに来てください。	by all means, at any cost 是非ぜひ、うちに来きてください。 By all means come to my house.  6233
敬語 Noun お客様には敬語を使いなさい。	honorific language, polite speech お客様きゃくさまには敬語けいごを使つかいなさい。 Use polite language to customers.  16982
尊敬 Verbal Noun 祖父は家族みんなに尊敬されています。	respect, honor 祖父そふは家族かぞくみんなに尊敬そんけいされています。 My grandfather is respected by the whole family.  2972
ひじ Noun 彼はひじに怪我をした。	elbow 彼かれはひじに怪我けがをした。 He injured his elbow.  14514
敷く Verb 生まれて初めて布団を敷いた。	lay out, spread 生うまれて初はじめて布団ふとんを敷しいた。 I laid out the futon for the first time in my life.  3199
雷 Noun 雷が鳴っています。	thunder, lightning 雷かみなりが鳴なっています。 Thunder is rumbling.  1956
零 Noun 今ちょうど零時です。	zero, naught 今いまちょうど零れい時じです。 It's exactly midnight now.  5460
仕舞う Verb 彼女は大切な書類を机に仕舞った。	put away 彼女かのじょは大切たいせつな書類しょるいを机つくえに仕舞しまった。 She put the important documents away in her desk.  14119
ひも Noun 靴のひもが切れた。	laces, string, rope 靴くつのひもが切きれた。 The shoe lace is broken.  9153
踊る Verb 彼女はクラブで踊るのが好きです。	dance 彼女かのじょはクラブで踊おどるのが好すきです。 She likes to dance at the club.  2233
踊り Noun この踊りは易しいですよ。	dance, dancing この踊おどりは易やさしいですよ。 This dance is easy.  4535
踏む Verb 運転手がブレーキを踏んだ。	step on, tread on 運転手うんてんしゅがブレーキを踏ふんだ。 The driver stepped on the brake.  1484
踏切 Noun その踏切は長い。	railroad crossing その踏切ふみきりは長ながい。 This railroad crossing has a long signal.  28754
まく Verb 日本では、二月に豆をまく行事がある。	scatter (st), sow seeds 日本にほんでは、二月にがつに豆まめをまく行事ぎょうじがある。 In Japan, during February, there's a bean throwing festival.  3937
蹴る Verb ゴールキーパーがボールを蹴った。	kick ゴールキーパーがボールを蹴けった。 The goalkeeper kicked the ball.  1790
食堂 Noun 大学の食堂は安い。	dining hall, restaurant 大学だいがくの食堂しょくどうは安やすい。 The university cafeteria is cheap.  2660
猫 Noun 私は猫が大好きです。	cat, feline 私わたしは猫ねこが大好だいすきです。 I love cats.  1012
文章 Noun 彼は文章がとてもうまい。	writing, prose 彼かれは文章ぶんしょうがとてもうまい。 His writing is very good.  2141
やかん Noun やかんでお湯を沸かしました。	kettle やかんでお湯ゆを沸わかしました。 I boiled water in the kettle.  27510
丈夫 Adjectival Noun 祖母は身体が丈夫だ。	healthy, stout 祖母そぼは身体からだが丈夫じょうぶだ。 My grandmother is physically strong.  6643
また Adverb 明日、また来ます。	again, also, or 明日あした、また来きます。 I'll come again tomorrow.  100
お祖父さん Noun 私のお祖父さんは毎日散歩します。	grandfather 私わたしのお祖父じいさんは毎日散歩まいにち さんぽします。 My grandfather takes a walk every day.  5167
お祖母さん Noun 彼女はお祖母さんと住んでいる。	grandmother 彼女かのじょはお祖母ばあさんと住すんでいる。 She lives with her grandmother.  6866
ようこそ Adverb 日本へようこそ。	welcome 日本にっぽんへようこそ。 Welcome to Japan.  13192
祖父 Noun 祖父は元気です。	grandfather 祖父そふは元気げんきです。 My grandfather is well.  2542
祖母 Noun 祖母は京都で生まれました。	grandmother 祖母そぼは京都きょうとで生うまれました。 My grandmother was born in Kyoto.  3293
邪魔 Adjectival Noun 邪魔です、どいてください。	obstacle, interruption 邪魔じゃまです、どいてください。 You're in the way, so please move.  1949
風邪薬 Noun この風邪薬を飲みなさい。	remedy for a cold この風邪薬かぜぐすりを飲のみなさい。 Take this cold medicine.  42249
ウェーター Noun ウェーターが水を運んできました。	waiter ウェーターが水みずを運はこんできました。 The waiter brought some water.  137227
風呂屋 Noun 昨日、友達とお風呂屋さんに行った。	bathhouse, public bath 昨日きのう、友達ともだちとお風呂屋ふろやさんに行いった。 I went with a friend to a public bath yesterday.  33230
風呂 Noun 父は今お風呂に入っています。	bath 父ちちは今いまお風呂ふろに入はいっています。 My father's in the bath now.  3087
昭和 Noun 私の両親は昭和生まれです。	Showa era 私わたしの両親りょうしんは昭和しょうわ生うまれです。 My parents were born in the Showa era.  881
紫 Noun 彼女は紫のドレスを着ていた。	purple 彼女かのじょは紫むらさきのドレスを着きていた。 She wore a purple dress.  2579
そんなに Adverb 一度にそんなにたくさんはできない。	like that, so 一度いちどにそんなにたくさんはできない。 You can't do that much at one time.  877
紅茶 Noun 温かい紅茶が飲みたい。	black tea 温あたたかい紅茶こうちゃが飲のみたい。 I want to drink hot tea.  4892
梅雨 Noun 梅雨は6月頃です。	rainy season 梅雨つゆは6月頃ろくがつごろです。 The rainy season comes around June.  12324
桃 Noun 私の一番好きな果物は桃です。	peach, peach tree 私わたしの一番好いちばん すきな果物くだものは桃ももです。 My favorite fruit is peaches.  6384
遭う Verb 彼は交通事故に遭った。	encounter something (unexpected) 彼かれは交通事故こうつう じこに遭あった。 He had a traffic accident.  3917
枕 Noun 私は低い枕が好きです。	pillow 私わたしは低ひくい枕まくらが好すきです。 I like thin pillows.  3803
嘘 Noun 嘘をついてはいけません。	lie 嘘うそをついてはいけません。 You mustn't lie.  823
遠慮 Verbal Noun 私は遠慮します。	reserve, hesitation, forethought 私わたしは遠慮えんりょします。 No thanks, I'll pass (on that).  2693
叱る Verb 父親が子供を叱っている。	scold, tell off, reprimand 父親ちちおやが子供こどもを叱しかっている。 That father is scolding his children.  2798
傘 Noun 電車に傘を忘れた。	umbrella, parasol 電車でんしゃに傘かさを忘わすれた。 I left my umbrella on the train.  3603
おじょうさん Noun おじょうさんはおいくつですか。	young lady, your daughter おじょうさんはおいくつですか。 How old is your daughter?  41087
年賀状 Noun 昨日、年賀状を出しました。	New Year's card 昨日きのう、年賀状ねんがじょうを出だしました。 I sent my New Year cards yesterday.  22640
賑やか Adjectival Noun 浅草は賑やかな街です。	lively, exciting 浅草あさくさは賑にぎやかな街まちです。 Asakusa is a lively town.  7659
蚊 Noun 蚊に足を刺された。	mosquito 蚊かに足あしを刺さされた。 I was bitten on my foot by a mosquito.  7128
拭く Verb タオルで体を拭きました。	wipe, dry タオルで体からだを拭ふきました。 I dried myself with a towel.  3213
挨拶 Verbal Noun 彼女は笑顔で挨拶した。	greet, greeting 彼女かのじょは笑顔えがおで挨拶あいさつした。 She greeted me with a smile.  1257
伴う Verb その仕事は危険を伴う。	accompany, go with その仕事しごとは危険きけんを伴ともなう。 Danger comes with the job.  3441
巻く Verb 彼は頭にタオルを巻いていた。	roll (st) up, wind, wrap 彼かれは頭あたまにタオルを巻まいていた。 He had a towel tied around his head.  1314
靴 Noun 靴が汚れた。	shoes, boots 靴くつが汚よごれた。 My shoes got dirty.  1503
靴下 Noun この靴下は3足で1000円です。	socks, stockings この靴下くつしたは3足さんそくで1000円せんえんです。 These socks are 1,000 yen for 3 pairs.  7356
磨く Verb 靴を磨いてください。	polish, grind 靴くつを磨みがいてください。 Please polish your shoes.  5011
歯磨き Noun 歯磨きはしましたか。	toothpaste, brushing one's teeth 歯磨はみがきはしましたか。 Have you brushed your teeth?  50154
廊下 Noun 廊下は走らないでください。	hallway, corridor 廊下ろうかは走はしらないでください。 Don't run in the hallway.  717
瓶 Noun 瓶ビールを注文した。	bottle, flask 瓶びんビールを注文ちゅうもんした。 I ordered a bottle of beer.  3651
褒める Verb 頑張ったので褒められました。	praise, commend 頑張がんばったので褒ほめられました。 He was praised because worked hard.  5818
元旦 Noun 元旦に彼から年賀状が来た。	New Year's Day 元旦がんたんに彼かれから年賀状ねんがじょうが来きた。 I got a New Year's card from him on January 1.  19294
袖 Noun このシャツは袖が短い。	sleeve このシャツは袖そでが短みじかい。 This shirt has short sleeves.  2312
長袖 Noun 今日は寒いので長袖を着ました。	clothes with long sleeves 今日きょうは寒さむいので長袖ながそでを着きました。 I put on a long-sleeved shirt because it's cold today.  26761
半袖 Noun 今日は、半袖のシャツを着よう。	short-sleeved shirt 今日きょうは、半袖はんそでのシャツを着きよう。 I'll put on a short-sleeved shirt today.  21888
馬鹿 Adjectival Noun 私は馬鹿だった。	fool, nonsense 私わたしは 馬鹿ばかだった。 I was foolish.  1636
凄い Adjective 凄い雨になった。	wonderful, terrible 凄すごい雨あめになった。 It began raining cats and dogs.  2446
剃る Verb 父は毎日髭を剃ります。	shave 父ちちは毎日髭まいにち ひげを剃そります。 My father shaves every day.  7642
喧嘩 Verbal Noun 喧嘩はやめて。	fight, quarrel, argument 喧嘩けんかはやめて。 Stop fighting.  2243
叩く Verb 彼は子供のおしりを叩いた。	tap, hit, play (drums) 彼かれは子供こどものおしりを叩たたいた。 He slapped his child on the bottom.  783
噛む Verb もっとよく噛みなさい。	bite, chew もっとよく噛かみなさい。 Chew your food better.  2219
味噌汁 Noun 私は毎日味噌汁を飲みます。	miso soup 私わたしは毎日まいにち味噌汁みそしるを飲のみます。 I have miso soup every day.  10776
姪 Noun 私の姪は3才です。	niece 私わたしの姪めいは3才さんさいです。 My nieces are three years old.  8903
苺 Noun この苺はとても甘い。	strawberry この苺いちごはとても甘あまい。 This strawberry is very sweet.  23551
茄子 Noun 夕飯に茄子の天ぷらを食べました。	eggplant 夕飯ゆうはんに茄子なすの天てんぷらを食たべました。 I ate eggplant tempura for dinner.  18956
逢う Verb ついに素晴らしい女性に逢えた。	meet (esp. sb of the opposite sex) ついに素晴すばらしい女性じょせいに逢あえた。 I've finally met a wonderful woman.  2647
椅子 Noun そのお年寄りは椅子に座った。	chair そのお年寄としよりは椅子いすに座すわった。 That old person sat on a chair.  725
痩せる Verb 私は少し痩せました。	lose weight, become thin 私わたしは少すこし痩やせました。 I've lost a little weight.  3220
箸 Noun 箸を上手に使えるよ。	chopsticks 箸はしを上手じょうずに使つかえるよ。 I'm good at using chopsticks.  4149
糊 Noun 糊で2枚の紙を貼り合わせた。	glue, (clothing) starch 糊のりで2枚にまいの紙かみを貼はり合あわせた。 I stuck two sheets of paper together with glue.  16994
醤油 Noun もう少し醤油を足してください。	soy sauce もう少すこし醤油しょうゆを足たしてください。 Please add a little more soy sauce.  9391
鋏 Noun この鋏はよく切れる。	scissors この鋏はさみはよく切きれる。 These scissors cut well.  12068
鞄 Noun その黒い鞄は僕のです。	bag, handbag, briefcase その黒くろい鞄かばんは僕ぼくのです。 The black briefcase is mine.  3619
顎 Noun 顎が痛い。	jaw, chin 顎あごが痛いたい。 My jaw hurts.  1822
飴 Noun 缶に飴が入っています。	candy, sweets 缶かんに飴あめが入はいっています。 There's some candy in the can.  16027
石鹸 Noun 石鹸で手を洗ってください。	soap 石鹸せっけんで手てを洗あらってください。 Please wash your hands with soap.  11972
差 Noun 都心と地方では収入に大きな差があるね。	difference 都心としんと地方ちほうでは収入しゅうにゅうに大おおきな差さがあるね。 There is a big difference in income between rural and urban areas.  2354
失う Verb 彼は地震で親を失いました。	lose, miss 彼かれは地震じしんで親おやを失うしないました。 He lost his parents due to the earthquake.  546
外れる Verb びんのふたが外れません。	come off びんのふたが外はずれません。 The jar's lid won't come off.  3998
測る Verb このドアの高さを測ってください。	measure, gauge このドアの高たかさを測はかってください。 Please measure the height of this door.  6848
含める Verb 私を含めて10人が参加しました。	include 私わたしを含ふくめて10人にんが参加さんかしました。 Ten people participated, myself included.  3198
含む Verb その食品は有害物質を含んでいるぞ。	contain, include その食品しょくひんは有害物質ゆうがい ぶっしつを含ふくんでいるぞ。 The food contains a poisonous substance.  1674
頂戴 Verbal Noun それ、ひとつ頂戴。	getting, receiving それ、ひとつ頂戴ちょうだい。 I'll have one of those.  5616
